ResponseId,positive,neutral,negative,unknown,total
R_3My5nJEWBlBcLYJ,4,4,0,0,8
R_tX8yyL4o62ToMnL,7,1,1,0,9
R_1ilK5EO6g0cdv10,9,0,0,0,9
R_3MrtRv0VUALapKr,4,3,1,0,8
R_31hIfVMGevmjlKW,5,3,0,0,8
R_29uIcUu3WovwpGC,7,5,1,0,13
R_2OPwR4FvMWrWV6C,5,4,1,0,10
R_RelOLwGzOb1Cmn7,8,3,0,0,11
R_3L10QZjFZxshFu8,0,9,0,0,9
R_1LoI85ASghYP6bL,5,0,0,0,5
R_XSdQB2HVdBCpkGZ,7,0,0,0,7
R_1Hodwhu3djqtuBw,3,3,0,0,6
R_3Jq3i5Tha6OvA89,1,2,6,0,9
R_2Enmn7IBkcOWShm,7,2,0,0,9
R_Adj8jdKiczVSTS1,9,1,0,0,10
R_1lrxjwdE9Y75ycu,1,4,0,0,5
R_VUMfn6MI2knQINj,6,3,0,0,9
R_2wAKWs9HixH0xly,7,3,0,0,10
R_1mVKWUcxMB1uu9h,7,2,0,0,9
R_u49E00k0Y58IU8x,10,0,0,0,10
R_2dYpzntZbgSZsEp,4,4,0,0,8
R_2fASkgGMdacOZyt,6,2,2,0,10
R_3Eiqffd8ghPLWQQ,1,4,1,0,6
R_1j6UZLZGypFcph8,7,2,0,0,9
R_1QoUu11uLV1kOQu,1,5,3,0,9
R_2ZKoLxMXsVos7Ks,4,5,1,0,10
R_23ZZOGskHayTfNw,8,2,0,0,10
R_w5ArLLx1nYcjQE9,1,5,4,0,10
R_2ZCtiPu7tytiS7z,7,4,0,0,11
R_1qdFlxNWDT8T1xC,9,0,0,0,9
R_2zBW2qbkmci68jK,6,6,0,0,12
R_10Hk1uxoEdYYMnJ,8,1,0,0,9
R_3h6msW4i3LyTog6,10,2,0,0,12
R_1FtZ0TvkXpfgQWS,3,2,1,0,6
R_3O65ozs9jxEqEI2,7,2,1,0,10
R_41ti3PRaZhlCqQN,4,3,3,0,10
R_31N6F9OBsdlYM7m,7,2,0,0,9
R_1H2D7JzT2mOMZ0B,9,1,0,0,10
R_1r9eJ17NMP1E0wE,8,1,0,0,9
R_z7FUHNGnOH8HzJT,7,3,1,0,11
R_1CpTipAVwdJ7m4x,8,1,1,0,10
R_2Ec1p1c8FgfaOE4,4,6,0,0,10
R_1Kx92flJkJxQTXw,3,4,2,0,9
R_e5JnuL0zjJ1hUTn,7,3,0,0,10
R_2ALm0fydCaMI09N,6,2,2,0,10
R_2xz8LCg0kuW7cKu,5,4,0,0,9
R_3Hq80YPgoZm63CW,0,2,6,0,8
R_XCkyZzfSWuvTnBD,5,4,0,0,9
R_29suJXnptK5r7TQ,5,2,0,0,7
R_endNfeo3Ltk3fXz,4,4,0,0,8
R_3HhNLzPkrGVPt3G,5,4,0,0,9
R_2qrOYddztreuEqE,6,3,2,0,11
R_27DMY90c4fsCaRG,2,4,3,0,9
R_1P4V1XVSNJ4V1uB,8,1,0,0,9
R_277Keb7U30RXIRy,5,5,0,0,10
R_2Ylg58KBH34E28x,2,2,5,0,9
R_3s4aeth2iJdFEKw,4,4,1,0,9
R_3FRvls1v6hnXPzi,1,7,1,0,9
R_2WNjGNqekyfrdLM,6,3,0,0,9
R_aW5wdktSe6BWlEJ,2,1,5,0,8
R_2aejXpcxFq0hKMJ,5,1,2,0,8
R_A72iIlxsToDHI7T,5,2,3,0,10
R_33jwzwGgVQriDZX,7,0,0,0,7
R_2b3l4aSf3sY5S5v,6,3,0,0,9
R_VVfY0VnDXOk1JHr,5,4,0,0,9
R_3haOydxaKnGIIBo,5,4,0,0,9
R_2YbOyJ50vvk9olD,0,8,2,0,10
R_2BgEU3OjxBUpCbx,6,3,1,0,10
R_r9dMlc63KQfE397,4,5,1,0,10
R_2q9rby8kktFpk7p,3,2,3,0,8
R_28YQ5FKYwcG79Qb,4,5,0,0,9
R_3IcRuuJYgd3ynUh,2,6,0,0,8
R_w4V5HzOQ8drNEpX,6,4,0,0,10
R_2b0EhUHzkaYZShc,4,4,2,0,10
R_21zErFGM5MYMXjJ,5,1,0,0,6
R_3p5d3avjJjbkpvD,3,1,2,0,6
R_1CkZ5n2MunXVMdM,0,3,5,0,8
R_3nVJbRpnU52FqbD,0,7,1,0,8
R_25Qwb5qgFB3qBvJ,3,4,3,0,10
R_2V7unF5Q9Ck4Zxt,1,7,0,0,8
R_ZgcqHdjfzjtZb21,8,0,0,0,8
R_2bTxy3EPGbQWpFz,3,3,2,0,8
R_1dh1OeZG5Ih3TJb,3,4,1,1,9
R_wKMZYvIDK6aREzv,8,0,0,0,8
R_2XopDvyoMpRkoch,4,3,2,0,9
R_ahLUH9oFYrnOKYN,8,2,0,0,10
R_3Pq363JjzUWWyGc,6,3,0,0,9
R_OxJi3RuNiIlDg2t,3,7,0,0,10
R_2ZW78kOVju504Br,7,1,0,0,8
R_1mfTpMt3c1E3C5F,2,6,0,0,8
R_6hhALhSqskXxwZ3,8,2,0,0,10
R_WfJWLEQ8Ou1qw81,5,2,0,0,7
R_8iFdR1jmDEa4x6V,3,0,6,0,9
R_yDuadEOe0z1pjWN,7,1,0,0,8
R_3kDddW1RuJtxXXj,4,4,3,0,11
R_2VxtRgE05r8OKwR,7,3,0,0,10
R_1nOBt6JMFxxmUe4,5,5,0,0,10
R_1dMqaMkImLF4qVL,3,6,0,0,9
R_3elUrqbYRUATNNb,4,4,0,0,8
R_1hSWYn5LjiKes4p,6,3,0,0,9
R_1nW7PPkaB3Vd2Lb,2,0,9,0,11
R_3Pt7ecJCwWEHlhr,5,3,1,0,9
R_DHtC0LEcFnxk921,6,4,0,0,10
R_QfQbQDYzsIBx5tf,7,5,0,0,12
R_AKYGGFbwJKlmn85,4,2,1,0,7
R_2VpzpEFUgRvT2Lo,5,4,1,0,10
R_3Dj2zWntjHKXQqm,5,5,3,0,13
R_daOmmVbAAePou5j,3,6,0,0,9
R_1cSuweUaokFmnDK,3,5,0,0,8
R_OKbuMx8bGfLZ6lr,8,0,0,0,8
R_0xEDFp36YzE7Wnf,4,5,1,0,10
R_1H0P5bF4sm0A5QB,2,8,0,0,10
R_1H2GNz3ctejiWqt,5,2,0,0,7
R_BtwJSQkaEblYj0l,8,3,0,0,11
R_qQ210QfNoI9CSC5,6,4,0,0,10
R_3LZkQgT4dA3TtVs,7,0,0,0,7
R_1dhusCbFw1vbZWP,6,2,1,0,9
R_URwvL4B3QpPR369,0,6,2,0,8
R_2SepWD8qXA0WUsj,4,5,2,0,11
R_2chXdenQlNn08an,5,2,0,0,7
R_Xog7IjW2zgtrkPf,6,4,0,0,10
R_2e4Fvxp5DapzGCg,2,3,3,0,8
R_1IyZF3MoSkg26Un,5,1,0,0,6
R_1gUX7om2HvQjouw,4,2,3,0,9
R_3KZsf5gwmqvmrlw,5,3,2,0,10
R_3G8O5zWMTOADyq8,4,2,0,0,6
R_1eEtMgAyAi4ICLc,5,4,0,0,9
R_DxlrqUIN39MWprP,5,2,0,0,7
R_1pspZVXJ5kwJZGP,3,7,0,0,10
R_USZaGM73kiBUamB,6,2,0,0,8
R_1mOTox8Y9HDSqtc,7,3,0,0,10
R_3NBRByRCVjiDJBZ,8,1,0,0,9
R_b33Lv2XQsY0EdFf,4,3,2,0,9
R_2QtCUSefD5EGtyC,4,5,0,0,9
R_27NlwR3j3m8Vkdq,9,2,0,0,11
R_31Kvzvaz5q1dLUO,1,1,3,0,5
R_1kNYI86YkIKV0lG,4,2,0,0,6
R_0IICzqUKUiviYdX,8,2,0,0,10
R_bBGPypm9IbT5CH7,7,4,0,0,11
R_vUFP8aRHxzSl39v,0,3,4,0,7
R_20MPGtGXcxaNduO,6,2,2,0,10
R_1jvbSis25hsbB5a,7,4,0,0,11
R_3dPTjksN2ByWF3R,1,6,1,0,8
R_2B5OU903eek4qhr,5,5,0,0,10
R_2SfaB8QZpx5VhwE,2,5,1,0,8
R_2471h4YDGb9unZb,7,2,0,0,9
R_27HTvkivHELB0cy,7,2,0,0,9
R_3k6BNqK9Wel2WVK,6,0,0,0,6
R_2s1nDUpgS1jbiRn,5,1,0,0,6
R_1QzsKm6FWDuFYGJ,10,0,0,0,10
R_2WvcXUFzWdQ5iXx,2,2,4,0,8
R_xhjZaemQ6XgpzmV,4,4,1,0,9
R_3Ph6BorxZI88VC6,4,6,0,0,10
R_10PnfZKe1rXf7wT,10,0,0,0,10
R_2xAa2QihZAZ2HSo,9,2,0,0,11
R_bJGYBxWTOJxkrWF,3,9,0,0,12
R_0AlfxuzhoLsfRfj,2,7,0,0,9
R_3gYERFM2jxhBCqh,6,5,0,0,11
R_20TBchdhDwpDiVO,4,5,1,0,10
R_2fD9EBZISoNxala,3,7,0,0,10
R_26fnDJtf5fGJD7v,1,7,1,0,9
R_2D5iYvNaXAwCYVP,4,3,1,0,8
R_1mI5gML75vnGd0f,1,8,0,0,9
R_1MR7sLr8U1YGj4a,8,4,0,0,12
R_1MSU3uZydA7FgBB,6,4,0,0,10
R_2q8iJSbPrTvTzty,3,3,3,0,9
R_1Hbg22MjAyS8Fcd,6,0,0,0,6
R_1gGbmU7KOP6Oj6f,6,2,0,0,8
R_1Oxhrt4gaaQdWpR,2,1,2,0,5
R_2qx9R9JF8ianuVw,5,2,0,0,7
R_0qAC2RHbZ9fuHtv,6,2,0,0,8
R_1JFRu8sUzMF4Mrs,8,2,0,0,10
R_1CalCI0bI16oUJP,3,9,0,0,12
R_1AhTuyP70tKU25P,4,5,0,0,9
R_1OZWvpFO04mn9IC,7,2,0,1,10
R_2ffjzA9xPEcQVFG,5,2,0,0,7
R_2zYizFubawlxMEg,5,5,0,0,10
R_2EAivoxqTH0H4MV,2,7,0,0,9
R_24vHvMrFrA6xziq,5,1,0,0,6
R_2SjGm3vOq0T2fcL,5,2,3,0,10
R_2teRfOc9DzoS9ks,0,4,2,0,6
R_3q7g9FqRTLPyeb2,6,4,0,0,10
R_33pBTrdItMfPlyY,3,0,6,0,9
R_1N4IG73bobiZV6w,3,5,2,0,10
R_33yd5siT1euIav1,6,3,0,0,9
R_2iqHLbGhJ9aW3Rv,3,5,1,0,9
R_1DYZoy8lvuYPMTe,3,2,0,0,5
R_b3HgWYbJ8vRVx7j,8,2,0,0,10
R_2dxR8E07qw1uiek,4,4,2,0,10
R_r8ElUHaU1qSUpXz,2,2,3,0,7
R_2ARTnLLA1C9yg1V,2,7,0,0,9
R_cOUlx92FJVlCFcB,2,4,0,0,6
R_2xwR2Eer81roDqk,4,1,3,0,8
R_27DwMi3q3spD60o,3,5,2,0,10
R_3PcRToEUWk5pgSl,4,4,0,0,8
R_u9S1XDvMR3MBA4N,4,4,0,0,8
R_2TnpVZwExJWh6ew,9,1,0,0,10
R_0MzJdiucOXZUoAF,4,5,0,0,9
R_C7bMkS5vh2wPWYp,3,4,1,0,8
R_1UfVKpeedtaZgo9,3,6,0,0,9
R_Z9ttqeFcdte8x6V,0,0,8,0,8
R_2fe3KyFExtMQYh4,6,2,0,0,8
R_ZDHI8AkdytmtJIZ,3,6,0,0,9
R_2azwJ1a1b71NFvk,3,2,1,0,6
R_27JyYKSbX3sJezM,7,5,0,0,12
R_3MogbcsArSjqGCV,3,5,0,0,8
R_2AGdrS7sKXGZdQQ,1,7,0,0,8
R_bO5iGiW8pdWFyox,5,5,0,0,10
R_2AYXEBnQW8qEdq4,5,5,0,0,10
R_5tYiGY5TfjvWYal,6,2,0,0,8
R_2e8taNECKTH30pT,5,2,2,0,9
R_31pDJKq1zDutc7i,2,4,4,0,10
R_piWN1l9Q7FnG6aJ,3,6,1,0,10
R_1K6VhJ2Hotz8fx8,5,1,1,0,7
R_83bccUrOvP3thv3,4,2,2,0,8
R_stjcx23rlXTCPJv,5,4,0,0,9
R_3RkBsABVREs06Ic,7,5,1,0,13
R_3DimpuKEG22WyVj,9,1,0,0,10
R_3oXtpe6nDwxIT8s,7,4,0,0,11
R_0DMt0alimN4KBQl,5,4,0,0,9
R_2aLcP5fvlLGFNgt,5,4,0,0,9
R_vDoDJAtyo3uFkJ3,5,3,1,0,9
R_1Ow5OaJtP9E3Tsn,6,3,0,0,9
R_3EFH21YsdVmLp4W,6,2,1,0,9
R_24xfL4xl1zSEJJh,7,2,1,0,10
R_NUBjvUmhTfBU3Tz,3,2,2,0,7
R_1lyFY91S3KqMKDz,3,6,0,0,9
R_1H12fPIvatEsB9m,4,6,0,0,10
R_2Yuet59ttkRCpma,5,4,1,0,10
R_129C7KkMCytdaO5,4,2,1,0,7
R_5bYi584TofKsGK5,8,2,0,0,10
R_3M598j0ZiWYitUT,3,4,2,0,9
R_5usoovquG9sRE9H,6,0,0,0,6
R_1f2Dro8wXAJKiiN,6,3,0,0,9
R_1lnPvV0gIRQrPRI,4,5,0,0,9
R_2fcIJXLbpC2pBG2,2,3,5,0,10
R_usG7LetYP77T9bb,7,1,2,0,10
R_1g1kzGIj4Gr3Evw,5,4,1,0,10
R_3M6hxFN5RcFs7cd,6,2,0,0,8
R_3nB4S5A3IiMFVZl,6,4,0,0,10
R_1LduYveMMeLIdCV,4,6,1,0,11
R_07CNmndAdX2BEB3,5,1,2,0,8
R_2EzZ8uCaYMXQ1gm,7,2,1,0,10
R_refhG3A9jDbc8HT,1,4,1,0,6
R_1q3bnLEqnxBinc2,3,2,2,0,7
R_ugB7l6t20F02MbT,4,4,0,0,8
R_SMEiVEWOCnkLIKR,4,1,0,0,5
R_1FRmfYVK1hLisGM,7,4,0,0,11
R_3GoXa8m8iwFkV14,6,0,0,0,6
R_24OvJUsd0cllWpp,9,1,0,0,10
R_2cBiURHEM8QxyfI,5,3,2,0,10
R_2dXEGQQqhUzHO6N,3,5,0,0,8
R_ctKau98eELujHTb,5,4,1,0,10
R_29tcmre4rbw9ONa,8,2,0,0,10
R_2ZOe91JXf9jJhb2,7,2,0,0,9
R_3Rg9aVdf9zdBfCd,0,1,5,0,6
R_1jND35jvQkasr66,6,2,0,0,8
R_UaVS02XLj6cp6g1,6,4,0,0,10
R_xo74s607VfARgMp,7,1,0,0,8
R_1gLUikYrhWnWPiB,6,3,0,0,9
R_1PYwcrBIXusK1kU,6,1,3,0,10
R_12fNbdCdDieMWBm,1,3,5,0,9
R_10YiGDdMJilsrbN,8,1,0,0,9
R_vMlnBIHEnnipaBr,5,5,1,0,11
R_2yduJ9e9GESM9G3,2,2,4,0,8
R_2DSw0uxoAgtHiGS,3,6,0,0,9
R_3s5pK2I5eERzoGs,6,3,1,0,10
R_Q9VWOX7jD9xJzJT,5,1,4,0,10
R_3Jrvz6GlJdpvNT2,4,1,1,0,6
R_12tklM4za9VdN7g,1,5,0,0,6
R_2ZEpH33h50JPN9n,7,2,1,0,10
R_6VfRn6zGIPUYq7n,2,3,1,0,6
R_bjdVNGub8WsnIqJ,4,0,0,0,4
R_1yOKtK1HLyynjUJ,3,5,0,0,8
R_yJSDFyq2OSiNlw5,1,1,0,0,2
R_W1XWV7K3NJK9slP,8,4,0,0,12
R_3sb2qU0yXZQEq91,5,3,0,0,8
R_3Kw2yLtuJFpNMlJ,3,1,3,0,7
R_3PLvUR5ZfYT0qaT,1,1,0,0,2
R_2dmxOrNiJDrywqk,5,4,1,0,10
R_eJrhjl3GBDV2dup,5,5,1,0,11
R_2dZ1vc8TeMgzVGy,6,4,0,0,10
R_U9ZMoSkJEpjJCYF,1,5,3,0,9
R_3KjvB8whwL5061H,4,5,0,0,9
R_3fpBxqjupaSzVkm,4,8,1,0,13
R_2zcrX7s2XBEQBLR,7,3,0,0,10
R_6GymOmveTYCjDnX,5,1,0,0,6
R_24deqa4vF3YO56j,4,5,2,0,11
R_2tKA8KMFqcxfEXw,4,3,1,0,8
R_sdRv52BCpqmGCs1,7,4,0,0,11
R_3nPEIsquFIEQnPe,11,1,0,0,12
R_yjrbNA7NsfOZ1Dz,2,5,0,0,7
R_1FlKBipNoEvUGMX,7,1,0,0,8
R_2c1Tf9A7lyYc1Bf,5,3,0,0,8
R_2Y5hhqCLQ9BfNvV,1,4,0,0,5
R_b2D7ehaK1Ivlnt7,5,4,0,0,9
R_2bK7uFqwn0S5Lrm,5,2,1,0,8
R_rlSu83EQGMeR3Ql,5,6,0,0,11
R_CjqbLXi3fgZz8yt,6,4,1,0,11
R_3Rz0x3GQbSYLiP7,4,5,0,0,9
R_1nVJlSPMJB5KohJ,7,3,0,0,10
R_2tGamQ5NSYhuIL5,4,2,1,0,7
R_3Mn8z5Hc6ohH3qe,4,5,0,0,9
R_et9MC6fW00hwP2p,6,2,0,0,8
R_1BPejDRcYCWHzXD,1,7,1,0,9
R_57tiIIt6StNc2wp,5,1,1,0,7
R_80yI66vRvSxA5J7,1,4,0,0,5
R_1gGCTTXDjHp0WUy,6,4,0,0,10
R_3spLlvrZftm7jXU,5,2,0,0,7
R_29fUmidY9aDWaAu,7,1,1,0,9
R_3iJC16jYcDbhhEN,3,2,1,0,6
R_XHRkFinvRvx4oCd,0,3,3,0,6
R_2Vevs6uUFzyy7jh,5,2,0,0,7
R_b4uAV44zdqDlCHD,5,4,0,0,9
R_sG97noIjBlTmVYB,5,4,0,0,9
R_2CHdxbYWkCdglDe,4,4,2,0,10
R_1MXvqnlaplNurN0,5,5,0,0,10
R_1QKqWk1KudShWav,9,3,0,0,12
R_2ayQjd55jxtvZYG,4,6,0,0,10
R_1DZITnLleigYZ3x,6,3,0,0,9
R_28zya6noD8t59aG,6,5,0,0,11
R_2rHjbUpBKs0wdCp,4,5,0,0,9
R_3oUeRIFniVkInB8,6,0,0,0,6
R_BE6xvTtm2AcW9P3,7,6,0,0,13
R_12zCWi5sFQr1uyD,6,4,0,0,10
R_1QgvcX9QFmBXVsQ,8,3,0,0,11
R_p5WNBu2lDg7pL3j,1,2,4,0,7
R_2tMs34jVnfxK3I3,4,6,0,0,10
R_1rijg4t5ZwXQBtr,7,3,0,0,10
R_2Tu5CbbzKCY1A9q,6,2,0,0,8
R_3KU7NkvibCsUTJT,8,0,0,0,8
R_2doQcpwa6nxP1No,0,4,4,0,8
R_1H5iPqJVTUtEu5N,1,2,3,0,6
R_25GcrzHsgTL7Okm,5,4,0,0,9
R_1LYy9LNTR6v7cg0,6,3,1,0,10
R_1E7pQiu2BuknK6w,10,0,0,0,10
R_b2xqUgPEOtAfRVD,0,1,6,0,7
R_3F4cqL27e6r2fb2,5,2,1,0,8
R_1ERxQTscgBa0zbX,1,2,3,0,6
R_1NwSgdVHgt2o1l2,6,1,0,0,7
R_bsBjl3mgmjgOMJX,4,3,1,0,8
R_b31yG88Gz0Y909b,4,2,4,0,10
R_3PuXVIFeantsIQW,2,7,1,0,10
R_33sw4aPNrpMaaox,2,4,2,0,8
R_vfwz4n3tNiu3E2d,3,5,0,0,8
R_1psyDt5NNmacAQl,10,0,0,0,10
R_C3sBFGXa1B9o5Nf,4,8,0,0,12
R_1ouLrinN5XToHbE,6,4,0,0,10
R_2q9Q1sPb10HK6PZ,7,1,0,0,8
R_3hnnSFjQmymoj4E,6,1,0,0,7
R_1g105I61uw55sIJ,6,4,0,0,10
R_4VIralArUHGxA8V,7,1,0,0,8
R_yHZbkEMGI6Nrjrz,5,2,0,0,7
R_ULpHlvsTUBSRwul,6,2,0,0,8
R_ZqOpkgYTxemcyEV,5,5,0,0,10
R_1pxQEfTubGwt3EN,7,2,0,0,9
R_2rZqqc6I6j3erMl,6,4,0,0,10
R_1DUQgbnC22SGo1s,6,2,0,0,8
R_1Qsa5z23uCemHEt,6,2,0,0,8
R_3DtNQFS2VaH690b,6,3,0,0,9
R_1IxRKyfrUgmygeX,8,2,0,0,10
R_1kGOBrumx9brqf8,6,2,1,0,9
R_sj1Q4aeFh4h95OV,2,2,4,0,8
R_3dEQNcngp8N4eng,7,2,1,0,10
R_sMCytGmxYH5mcLv,2,5,2,0,9
R_3031VlFWxVckvgr,3,3,2,0,8
R_URTQsuMWdMS4jf3,8,2,0,0,10
R_2agV9GjM6amjuOj,2,8,0,0,10
R_2wuFiLKCcGDDtko,2,3,4,0,9
R_eJ11SceJqfCplPb,0,2,5,0,7
R_25Sj8AMzxPPXs9D,8,1,0,0,9
R_ub6lr1tjVJ1ZqYV,7,2,0,0,9
R_1GJ3Gk6GR3d7OM0,3,0,6,0,9
R_1o13R5IFcE5GaIJ,1,5,0,0,6
R_2qFeGwG1b0dDRkq,4,4,0,0,8
R_2VOAZmreeiyMunn,4,2,3,0,9
R_C7khpmuCRtM7Z0l,11,0,0,0,11
R_2ROJ7ws2w3MqbFU,5,3,1,0,9
R_3nHGNHbqnj1JOtQ,4,1,5,0,10
R_bjXv2AIKC9t0nwB,10,0,0,0,10
R_2ty66fPqhgYFT7D,6,0,0,0,6
R_2X1J6X6J2TzWEMw,7,4,0,0,11
R_30jcJ1uUcLTt9Iy,4,3,2,0,9
R_1JJj3DMtTvTe8xE,5,4,0,0,9
R_Wr2rez2wa0qiuPf,2,2,3,0,7
R_9LdpMmvHWWSG9z3,8,2,0,0,10
R_1jPd12C9LZepkQv,6,1,0,0,7
R_2BlZxrhar2CJg0w,1,10,1,0,12
R_sqks6J1MWvZ2RC9,6,1,0,0,7
R_qyk3Vvo8kHUBMjv,4,1,3,0,8
R_3RemrelOlMQZjsA,9,2,0,0,11
R_3z7gOiishgwvR1n,6,0,2,0,8
R_110GfTzF2oXzs0q,5,5,2,0,12
R_1HcXAAPMdGdgXUJ,5,4,1,0,10
R_vUn3ns1MNs64QUh,7,4,0,0,11
R_oYLPa1gIVQhOxvH,9,1,0,0,10
R_2cpdnh823YLX0PC,3,3,3,0,9
R_3DhZHr5nHyvjaCs,7,3,0,0,10
R_2s71sV29lo0LSvd,7,2,1,0,10
R_WBu20dqHAeaWxXj,5,1,2,0,8
R_3Oi6m97IC2xGtDb,2,5,2,0,9
R_2uColiYFU3PoDBx,9,1,0,0,10
R_30iATwGG1QJW3bE,2,5,1,0,8
R_x6sInRztaX3chMt,4,1,4,0,9
R_2pXpOVmP3NCenyw,4,3,1,0,8
R_2dFpUFjtj5cSjJf,7,0,0,0,7
R_W0TVf79PbN6ooX7,7,2,0,0,9
R_TpD7tD2p3RnYX5v,5,3,0,0,8
R_2BfU09A5cXr6Ryo,8,1,0,0,9
R_2EmkGSWdkfO3dyH,2,6,0,0,8
R_11iRNWHCGgAioQj,3,4,1,0,8
R_28J2WCDhoIiWp1w,7,1,0,0,8
R_bduCfrJsDxGa5H3,4,6,0,0,10
R_2tmMEghGxTXYBp6,6,4,0,0,10
R_2ZNVuNUwIdf9k9V,6,2,1,0,9
R_3I5M2nEmldfHZdP,2,2,4,0,8
R_3Grzu0dTS7kHXfx,8,2,0,0,10
R_3KpCSYn6ZMmxcR0,6,3,0,0,9
R_302WduzJtrMgBsw,7,3,0,0,10
R_3Ems9viDfhd9V9m,6,1,3,0,10
R_27TmMmGbFpR1My5,5,4,1,0,10
R_3nrvSbXSVBCQZtQ,6,1,0,0,7
R_cBF6NIQ84XzkdFv,6,1,0,0,7
R_129HZSD1fsqaMA6,5,2,0,0,7
R_3KUveHJKdj0VPik,5,4,0,0,9
R_9tvgCPCdtlbYTnj,8,0,0,0,8
R_3nSCe4oRO1nQx5Y,7,2,0,0,9
R_xE4vB1roMgZhyj7,5,4,1,0,10
R_3h6LCHvh0rW4nJn,2,5,1,0,8
R_27wXCX4UVnnL6iJ,7,3,0,0,10
R_1re5rC6fR2gYOJ6,6,0,1,0,7
R_2BfUgHmRs7PVVSq,5,2,1,0,8
R_1C9ltzLyp6aQzzw,8,0,1,0,9
R_3dDE02ELySXPIRb,5,5,0,0,10
R_XAKVWZzNQ1XQOWJ,7,3,0,0,10
R_1lAZs11u2F2hBB3,5,2,0,0,7
R_1dpkoKral19EiUZ,6,4,0,0,10
R_1FhAA0Dji9fXz1D,5,2,0,0,7
R_u9T9g4O7Dt81TXP,6,4,0,0,10
R_1QKJjUTx6qIgZec,7,1,2,0,10
R_2Yr008A7s67PNFa,1,1,6,0,8
R_1g6gVZvnPDeGWpb,3,2,0,0,5
R_7P5P0QM2hmVcOVH,4,1,0,0,5
R_2Tmx1u5GNnHbmSM,2,3,4,0,9
R_2cA9rN0D14y7CbY,6,3,0,0,9
R_33qmvyy7CjCh9dm,6,3,0,0,9
R_u4EzwI9zfvWe1k5,4,2,0,0,6
R_2qkosttOCOD8SOx,5,2,0,0,7
R_12P75A6dsGITwtr,3,3,4,0,10
R_2SHzEK606X9xmrB,5,4,1,0,10
R_2aQ5Js5qqqqIdZ3,8,2,0,0,10
R_1DZqWjCwkDSc8kY,5,6,0,0,11
R_XtgwtzTv1rG82Up,6,3,0,0,9
R_3oMg9Ex4XkwdKgl,4,5,0,0,9
R_1r84nAdJzgipTqV,2,5,0,0,7
R_3oztcb92gaOJnOX,4,6,0,0,10
R_2e2SPoiEb4LQ5WV,5,2,0,0,7
R_1erWpKMBO9mWd6Q,6,4,0,0,10
R_2fe9MDF2qguTkeh,4,2,2,0,8
R_3QYQlXHhula8xgn,3,3,0,0,6
R_2taQgk6NQyjwmAu,5,3,2,0,10
R_1dHtcKfSXaFtw4M,2,2,5,0,9
R_2QrLOVv6gUptnXT,1,2,5,0,8
R_2TC7HPiiJsssC7E,2,5,1,0,8
R_20SEZVcVFt6Qx80,7,1,0,0,8
R_3fDkk1NPgEz1oI7,5,5,0,0,10
R_30clNa9XQARuqrH,6,4,0,0,10
R_2347YBTpzEyT0ZE,6,3,0,0,9
R_AMvOydIYxQ1tXaN,5,4,1,0,10
R_DGCPhQuWy8AwZbj,5,2,0,0,7
R_2q3MbbJZW55k4wx,3,4,3,0,10
R_1K44ngRIQXzqLN4,8,2,0,0,10
R_umklR8VVeADOk7f,4,1,2,0,7
R_1pG5sCXCYtU0Ir8,7,4,0,0,11
R_1ptCSQ0Nasi9Tz9,8,1,0,0,9
R_3frd9NWmHLrZikF,8,2,0,0,10
R_2dEVT7Ix07Reftu,5,3,2,0,10
R_wSPAyyjNE0lsO2Z,4,3,0,0,7
R_2sXVBVHr7VpG4Ij,1,3,4,0,8
R_2awZFdDNxld2Ews,7,0,0,0,7
R_2TRbiMMFd2HNMJT,4,4,1,0,9
R_32PHFcladlIDH84,5,3,0,0,8
R_3gREy6LnJe590jS,5,5,0,0,10
R_1LzEcu5dda3ghHz,0,8,0,0,8
R_1eRA6yoCog6jRjd,8,1,0,0,9
R_33kiA8o01WAMAA2,9,1,0,0,10
R_21oFWhRACcM5ZBe,4,2,0,0,6
R_2zvgDjOKgv7RiVc,8,3,0,0,11
R_4Nv3mpr6adfjYdz,5,2,0,0,7
R_2yapZV2iJ6gFd15,7,2,0,0,9
R_dohXXqBXF4pf30d,0,2,5,0,7
R_vOh2vr3JGOJHOPn,8,0,0,0,8
R_3pulVn2bQploTUW,2,6,1,0,9
R_2dvkJ3mKyz5T7xe,5,6,0,0,11
R_ZK7ifpBEcUqrNN7,3,7,0,0,10
R_1QyJ7StwX6pSpPW,10,1,0,0,11
R_3FQaPLtKAPHaIkL,6,1,1,0,8
R_3kNFr2rbyhNzHt4,6,3,1,0,10
R_2dDTynxZpkjqPPi,1,1,4,0,6
R_5AQqb2AAbCeK3VD,1,2,4,0,7
R_3m90jxrAsYhdxKF,1,4,2,0,7
R_2dYYv6elYcje2mM,6,3,0,0,9
R_BQwooYYjWWKobL3,5,2,0,0,7
R_tYS871U9fG3RsqJ,4,4,1,0,9
R_51QwUfP6z8wHG9P,3,3,0,0,6
R_Aar123MqAQWDrxv,5,5,0,0,10
R_1q7HccoNQlARSTt,5,2,2,0,9
R_3KqoBtgnOosV0fK,2,6,2,0,10
R_1E7ii1QjYRx7V6H,6,0,1,0,7
R_3EA3ap9qXGinb0L,5,5,0,0,10
R_p48hpQ0Ov0FuZFL,7,3,0,0,10
R_1jk5iLgNRDjuSap,5,5,0,0,10
R_1hKHlsRS3gSSQSg,0,5,4,0,9
R_3qI5VES1OGv6k08,8,0,0,0,8
R_1jm7SNhGGeqdfh2,7,3,0,0,10
R_2zUsr5xVWsHAY41,4,6,0,0,10
R_3lRZjez7dm6mJZ9,5,4,1,0,10
R_3qst5ylccwdJ865,5,5,0,0,10
R_2afOlwzXpwInj26,4,2,0,0,6
R_AmtwnNLei8ImjU5,2,6,1,0,9
R_TqnHkhGdmaDS7IJ,6,2,0,0,8
R_10VG7mghCuBezNs,0,1,7,0,8
R_2PnDL10ZFdjvG69,5,7,0,0,12
R_3EhGAhcYn3ZlpEY,5,4,0,0,9
R_3RsJJipZI3bQ0HK,6,4,0,0,10
R_1fjF37QKYdwtOdv,8,3,0,0,11
R_Rslr8Z7KPrhlqdr,8,1,1,0,10
R_qEGNhgZ75Mjc4IF,8,1,0,0,9
R_3CDwWA8dadOIOGD,2,3,2,0,7
R_1mQKFJGYUkK23nb,2,4,1,0,7
R_2y3B3YFONyrAzOI,7,2,0,0,9
R_AMqkavzxllqXh5f,4,5,0,0,9
R_1LAkAo8D14oPWNA,7,1,1,0,9
R_2712fNWnaAyMQ9B,7,1,1,0,9
R_1FlJZPmNhVlEm2a,9,1,0,0,10
R_3xY6r8tzq9ns4Jb,6,3,0,0,9
R_yW897yn99iVozDz,2,2,1,0,5
R_28O19vKszinUo2L,8,1,0,0,9
R_2BrGPLCzROutsjA,6,4,0,0,10
R_3KuSVeyhnlityqb,8,1,0,0,9
R_2ydb1ZSyGF5tQkC,3,5,2,0,10
R_6XWpPfhrqcN2irv,4,2,1,0,7
R_r6FuqYqsfHW0yNb,7,1,1,0,9
R_2Cj4BZmNmOoFzDA,8,0,0,0,8
R_3noUC09gcyD1VS2,8,2,0,0,10
R_276XQ4p5ZzGDLfS,5,0,3,0,8
R_2CKadrJmZshWFDc,1,7,0,0,8
R_1DTKPhUFU5eOPqc,6,3,0,0,9
R_VOxV8cwuWrTc7h7,5,3,0,0,8
R_1r82J5xu0Zp2UmL,5,6,0,0,11
R_3neJs2rHbWF31CE,7,1,1,0,9
R_DSMAEs3dFaQsmWJ,6,1,1,0,8
R_2VwKuWDgp8i0ogv,3,5,1,0,9
R_2ClE2NATM7XFryE,5,3,0,0,8
R_2aWzmg46vZ9XoeY,6,1,0,0,7
R_2f1bTzxLVYFNAIu,3,2,5,0,10
R_VQYYRlwIaGnkNrj,5,5,0,0,10
R_3kAozTWi0QynwRT,6,4,0,0,10
R_1hHj6es98EPAMdM,7,0,2,0,9
R_2SDg7oxnlIKyivM,1,5,2,0,8
R_3EhAxcKiilgnWug,9,0,0,0,9
R_3s6xSTeoRy4Q0cu,9,0,0,0,9
R_rcYyNELN78Xc1IR,1,4,0,0,5
R_2zhZcYAGCvrd8K7,7,3,0,0,10
R_SW8VnnGbFARsOsN,2,6,1,0,9
R_1IilStqO4QN4VdR,4,2,0,0,6
R_1ojpEO6rWVlmd0b,0,7,0,0,7
R_1gNhnd7rIxXQoJq,7,4,0,0,11
R_1g0FHaVmoY9kMxK,3,7,0,0,10
R_29gn7tskiOFDgbJ,4,3,2,0,9
R_2TEJtNacqD9Owk9,3,6,1,0,10
R_2wT4k4w1mTPhHoF,7,2,0,0,9
R_3efDiSR9vaEj5iB,8,2,0,0,10
R_1GP44cH6jMbwZ4h,7,2,0,0,9
R_1rvsFjJ9Q6M6lRm,5,4,0,0,9
R_2WYmEW5VYJVk0rQ,5,5,0,0,10
R_2aVSg9VdDx0nFby,5,4,0,0,9
R_2dQFZJCP5Wt85I4,6,1,2,0,9
R_1IcSMnBN9LFGmBM,3,5,2,0,10
R_RgJUQOKCvXD8XAZ,3,3,2,0,8
R_2yau6LwnQGhsjLd,2,0,5,0,7
R_24C1dSTYzIH5F8O,8,5,0,0,13
R_2wiv6v14GpOON4b,4,3,0,0,7
R_3OyDQOQQFh1gRsB,5,4,1,0,10
R_2qDIMhVztxtgzhS,4,5,0,0,9
R_8vwVCLNVkombevL,9,1,0,0,10
R_305AgLtNkSjU10V,6,3,1,0,10
R_r09jRDug8UQYjbr,5,3,0,0,8
R_29h8e8Th2Qr2rYv,8,1,0,0,9
R_2OI57xNOgcecC5H,4,6,0,0,10
R_3hG6lcPqkGcxSj7,5,5,0,0,10
R_1pLqa9NHDgOq6VE,8,1,0,0,9
R_2VO6uR4YQhcT5Lv,6,2,0,0,8
R_8HT2Xxy8KzezAgp,8,1,0,0,9
R_cZUrZyTRzPDsHXb,7,3,0,0,10
R_Qcd1scHH08JHPvH,5,4,0,0,9
R_29tPXi9iwXzODSO,3,3,0,0,6
R_1IhiHmYmavrpQyz,8,2,0,0,10
R_eKasamN7LUjtX45,6,3,0,0,9
R_2Pk7iIVtwrVztt8,6,1,0,0,7
R_2PiEU8Uej2IZBjV,7,1,0,0,8
R_1n2bhAeZ8Yii5ON,2,4,3,0,9
R_3QKK5GLgUHdaM7B,5,5,0,0,10
R_33xznZrrwo3r0iE,6,3,2,0,11
R_3fPrlDckrNxZTUV,7,2,0,0,9
R_22WDWYhwSSKQL4s,3,3,0,0,6
R_2rjyrJKFl3dMv2n,5,4,1,0,10
R_2uqfTUER6JCBKrf,3,3,3,0,9
R_2zeaPI9vMufelBJ,7,1,0,0,8
R_1qWyNOt2QIEhc5z,8,1,0,0,9
R_1cUo7UBzCP4Nrnn,10,2,0,0,12
R_1j7jMLYi6fqILey,10,0,0,0,10
R_NWNcyicNNgfGLKN,5,4,1,0,10
R_3JIcIsyqUGLe083,8,0,0,0,8
R_1KvuwcRPPNMQKga,10,0,0,0,10
R_323ZPPNAkPXWP9k,10,2,0,0,12
R_DuUDEWtBkZ75gRP,5,4,0,0,9
R_1mOtLU9i8WDP763,6,4,0,0,10
R_3kiWM9SjSV1rIUS,5,3,1,0,9
R_3qpNPpLcwJW2IXn,2,5,3,0,10
R_2TS4P6fgU8D81N8,8,2,0,0,10
R_3EnkvQhlLtc8dt2,10,0,0,0,10
R_1FCVvcxJGa0iFKq,6,5,0,0,11
R_233JkzzyAUZywZZ,7,3,0,0,10
R_CgcNZndfZa7XHUt,7,6,1,0,14
R_ezzYJ5ZCknwEgCt,7,1,0,0,8
R_rlGT9cu2PtCW1A5,5,3,3,0,11
R_3niL0AjtyYViQek,3,4,0,0,7
R_3CPihlKx1VbrXg8,3,3,2,0,8
R_306tm0XU8MJ2F3l,2,2,1,0,5
R_vDj9atT6HPhHqJb,1,2,7,0,10
R_Y9VD22yguRjFlKN,5,1,0,0,6
R_2QzzWRDqM17mIsz,8,0,0,0,8
R_2AKBnNCOkKKrvHd,8,4,0,0,12
R_sdiw0WNSeHj5HHP,9,1,0,0,10
R_3JaXwU58eADf1Cs,1,1,4,0,6
R_1qfxS92nttF6QQW,4,3,0,0,7
R_1CvxnVotwwwanqO,3,5,0,0,8
R_3255VdzTCBNI28a,5,5,0,0,10
R_UR85WcYvBDhHfnb,5,4,0,0,9
R_CfPevW5Ctf5BpLz,2,6,1,0,9
R_3I5bakqyPlrb01G,3,5,0,0,8
R_24OBtURZJiCtbtG,4,5,0,0,9
R_1DARPW2r6fJKHWk,7,4,0,0,11
R_O9TyNO0Pfb92CqJ,3,7,0,0,10
R_2SqrmSqGqeQXj9K,6,3,0,0,9
R_CjXWnISJ4AifdeN,1,3,4,0,8
R_2bTVM5f76oIUy8C,6,4,0,0,10
R_UtIg6KOtCbtByHT,5,4,1,0,10
R_SZuBoRXkLT9eCwp,9,1,0,0,10
R_RaGL4fZrLbNuIMx,11,2,0,0,13
R_3RyFc6IhmEsQVjW,1,9,0,0,10
R_VW15Zw0OyqcIx5n,8,0,0,0,8
R_2VgnXcZYoqFWHCd,8,2,0,0,10
R_RDiR4CRWxnjdTmp,3,4,2,0,9
R_866Nksnpusb27WF,0,6,2,0,8
R_2curr87oJ7ErDcH,3,5,1,0,9
R_UcpskVUeoiSId21,2,3,1,0,6
R_1dzRAPYmqztxMr1,7,2,0,0,9
R_Z7rr8kuhexAhCOB,7,1,0,0,8
R_vuBQJOCfLyLqP29,2,7,0,0,9
R_Y4apTYRQx3pRXQB,7,2,1,0,10
R_27VGezNWvNb5w4n,5,3,0,0,8
R_3qVBxer1TOi7UL9,6,3,2,0,11
R_1k04uOVoobnucCq,6,3,0,0,9
R_AhpNdAvVPdZXkv7,5,2,2,0,9
R_1NwAvigVIjZCe2q,5,5,0,0,10
R_2wNANmv8d3pK71z,6,1,2,0,9
R_2tXeHiuhDUTGVhf,7,2,1,0,10
R_YRY3nXf7rxXHlUl,6,1,0,0,7
R_2VlPj83xqtmmvd5,5,1,1,0,7
R_3fJk3ygxSqBy3NU,1,7,1,0,9
R_3KARHeygsQ5pMGu,3,2,5,0,10
R_333VVJiLh0I7vwq,3,5,0,0,8
R_31px1BnXQXZ7f6K,3,6,0,0,9
R_24OESUMwtbCQTH3,5,2,0,0,7
R_3r35mmqbDaqzvS2,3,3,3,0,9
R_2rM9hA29RJ1GMcT,5,3,2,0,10
R_3L4HgUqJmXl3Nqp,7,1,3,0,11
R_OpVYSPMy9SDVUe5,6,3,0,0,9
R_PTYtDpYFzSyHBeN,9,1,0,0,10
R_33rOfQMDC2dPw0K,7,4,0,0,11
R_3j8MVePIVYo9cii,2,7,0,0,9
R_2f8rWfcrw4Oi2gK,8,2,0,0,10
R_2xPDy9lvX1AOzhb,2,2,4,0,8
R_3NXmuMNwgiAuUxs,2,4,3,0,9
R_2XhACPLeHlAFCsT,0,1,11,0,12
R_SZeXiB0nIvRdRBv,5,7,0,0,12
R_2Vz2ZH9Ma0b1JSh,9,0,0,0,9
R_1gFsPHZVayOh2Uh,3,5,0,0,8
R_1CKLexG61xZDRAo,4,3,2,0,9
R_2ZK5D6ZHifzIOuu,4,5,0,0,9
R_7PuU5RwNqUxgrip,5,2,1,0,8
R_30bZMNnHuOWc91I,0,1,3,0,4
R_ZlQhR5M5CXiwr5f,1,4,2,0,7
R_26bgqUFHu67OcLm,6,2,0,0,8
R_XpT7qeUdPbPk2ch,2,4,2,0,8
R_1QsC2nzJJMWYyVH,6,4,0,0,10
R_1Fhqz42EJ7DBlcC,8,2,0,0,10
R_DVsdvJXPFkRsTAJ,2,8,1,0,11
R_dp7I5784Vm8lKdX,3,3,1,0,7
R_3gTsZBtyPOKcxmW,8,2,0,0,10
R_3KCmzofJpoRscIP,0,2,6,0,8
R_1OOzBhMRdJab1wM,8,2,0,0,10
R_23199kWVRWt1p4j,8,0,1,0,9
R_V4HlY5I8dGDmfLj,5,4,0,0,9
R_0rJc0sz5kE98uBP,2,3,1,0,6
R_2DUBsyaXfs31HNb,4,2,3,0,9
R_2uDHQUyZtPZhYI3,2,3,4,0,9
R_RDHFTWAYEQM7Ruh,9,0,0,0,9
R_yF8haZwmfurBNFT,1,5,4,0,10
R_5pU4wNikHzPsHxn,5,2,0,0,7
R_ebbqsHWmzWygeWd,8,1,1,0,10
R_2wytYdji8ebzAho,1,2,5,0,8
R_29iuOyk7wjJfotr,5,2,0,0,7
R_2EoWwQezM1HlRhz,9,0,0,0,9
R_2RalaNO4ocmYoo3,1,1,2,0,4
R_Zr8rbd5wJFNbz8t,5,7,0,0,12
R_1AB6SRxkChdyTPr,0,2,7,0,9
R_pJMiu2Kn8RXT26t,8,1,0,0,9
R_22IZF7XEkqdWg55,6,3,0,0,9
R_1BQl0e3mxza7T2f,9,0,0,0,9
R_1Ns5zWrd4pU8d3N,1,5,0,0,6
R_AGSmprfT85gBUo9,6,3,0,0,9
R_2wAjdNSLc9xi6xs,5,5,0,0,10
R_25SeXjJ7lFsFMFq,8,2,0,0,10
R_3m3maKfmysqmIZ7,8,3,0,0,11
R_1dMqnRfQFtw9gOR,8,2,0,0,10
R_3iCgBlTDfC7N90P,7,4,0,0,11
R_1eIRdjgdD8Jro1r,6,4,0,0,10
R_1mJHgTLt4vN0sjm,4,1,0,0,5
R_2SuxmZcbCb7W3oU,3,7,0,0,10
R_2zo9P4KW9wYZeVl,9,1,0,0,10
R_w6R6BwSvYxzPxF7,7,4,0,0,11
R_1mq1nNovEbteaUb,1,6,2,0,9
R_AMqeUQ6ISTclIoV,2,3,5,0,10
R_2w1qyaqSUizw2pJ,0,2,5,0,7
R_2CJRQ2irTOdp6nT,7,1,0,0,8
R_294IdSh9knjqzSf,6,3,0,0,9
R_21oCzaLdisMaiPD,1,4,0,0,5
R_1feEIzBOZ6VaBSt,2,5,4,0,11
R_1my0FwHwItTU2YU,3,1,4,0,8
R_1g1prPbUltcYabP,4,1,1,0,6
R_2rVoQN2wUx1fmo6,7,3,0,0,10
R_1Qu9xtMnRXZYm3Y,8,0,1,0,9
R_32RPomSArOdXisT,10,0,0,0,10
R_2dioigSop2AG201,1,5,2,0,8
R_1kIm70mlhUMFZ5C,3,8,1,0,12
R_3R7zKGnlLcyht6R,8,2,0,0,10
R_2QsMcqcDfYQhUQ1,6,4,0,0,10
R_xaZgZTmqZsQqNDb,2,8,0,0,10
R_1GTiXCRBrzA4pMu,5,1,1,0,7
R_RtnSYrJqqL6tSPD,4,4,0,0,8
R_r08jmwiRwr5998R,5,5,1,0,11
R_r0Euu95GBwUHRG9,2,2,4,0,8
R_3LXR1YQYuECc24u,4,3,2,0,9
R_21FLbTEiHTgaaYk,4,6,0,0,10
R_2VaJj2AMje2cGDf,2,6,2,0,10
R_3k4FwkcXw8Y6edE,0,1,0,0,1
R_1gjSSDVUc2KGJFo,4,3,3,0,10
R_3O7B5DIWolWduaP,5,5,1,0,11
R_24jXLk4zI0NIpvJ,9,1,0,0,10
R_2cwHzsToNwoIvr7,7,1,0,0,8
R_2PzDfajNrShwDpG,2,0,6,0,8
R_1hWl7d6SjILnIbn,6,6,1,0,13
R_O8yGsb2ksfMZSXn,7,1,0,0,8
R_2PbBDl8GY3A5E9F,5,3,0,0,8
R_3qCmjR1KkIIq516,9,1,0,0,10
R_2rj6U9EHOU3vtQw,3,6,1,0,10
R_1GvMhFZ1f9QXL2w,5,1,3,0,9
R_3svItndTMNdNlmB,8,1,0,0,9
R_ZBIcb3phjQq71Gp,5,3,0,0,8
R_VUtwz6LtP4KENX3,2,1,2,0,5
R_1r9s18nD2dhWbgI,2,4,0,0,6
R_1eOxkO0UGZsfBdf,5,2,1,0,8
R_2dWGNwOiQv7On6g,4,0,0,0,4
R_3D6kTydnb2FgSVi,5,4,0,0,9
R_UmDXUS9V9NApz7r,9,1,0,0,10
R_25c9kHwaqi9FSW5,5,6,0,0,11
R_24jVc5muEEGmYqM,8,2,0,0,10
R_12zhaDwaIq7qk1s,8,1,1,0,10
R_ufwSClkbWUBpnax,4,6,0,0,10
R_2uD5LXYbrRUjUfg,1,6,3,0,10
R_1kG15q36cFUcVXu,5,1,0,0,6
R_daOIwF525nE7pCN,3,6,0,0,9
R_24jcPSMVgthI4QZ,7,3,0,0,10
R_6QIv03cZAej4JRn,4,5,0,0,9
R_3hG6I3UBPY6ofQM,7,1,1,0,9
R_BYv0UenCIASwL7z,4,5,0,0,9
R_XNcqcWXctvbGpu9,7,1,0,0,8
R_Ol1C3ixiO8wRGc9,0,5,3,0,8
R_2e8VyfQdTUWOFSz,6,3,2,0,11
R_2Bam6nR63m8Ltww,4,4,0,0,8
R_30kQD7y883uEQA8,9,1,0,0,10
R_2YsvpCACnvYFksu,0,9,1,0,10
R_2AWOxtNsLHob61j,8,2,0,0,10
R_3qTI9dWgy1QHOQw,3,3,2,0,8
R_2foB8hxSmUzYkrS,6,2,0,0,8
R_2tK9vOlaJNa8lU0,2,4,3,0,9
R_2dYq1RIkmQA1Wsp,4,1,2,0,7
R_w4zn2jyuhaWWA0h,4,5,0,0,9
R_3pbrPswAjfJgz1w,5,4,0,0,9
R_1CqdSvj3RI8ko8K,8,5,0,0,13
R_2ceF8e0U4TjOMJE,4,5,0,0,9
R_qK534dwHQWoC67n,2,6,0,0,8
R_4MaPn1ZINWdcGKR,5,3,0,0,8
R_30eIsolDNqyhBKN,8,3,0,0,11
R_25WsXnTn9PkSchL,6,3,0,0,9
R_1dzfkW5cpj00txP,7,2,0,0,9
R_28M8fhRsbWoaIvM,4,2,2,0,8
R_3GxFsDnl9N51On1,3,4,0,0,7
R_8x2KDDir2cAhwUF,3,4,1,0,8
R_6zoxMJaLmaSMmLn,4,6,1,0,11
R_2q4U4UVqWwI7Dbm,10,0,0,0,10
R_12xSmjgRxr7nGm6,1,3,4,0,8
R_XYZOWH8drNB7qs9,5,3,1,0,9
R_3fTLZqfEY5kMPmk,1,6,1,0,8
R_1MYynO8qeFUOic5,5,0,0,0,5
R_8rbBThxdMCigzHr,4,1,2,0,7
R_3Eb9LAUmU2sIN3h,8,2,0,0,10
R_2aqJYCZOA1T2xSh,5,2,0,0,7
R_2R2IxkHJ54KLRTa,5,1,0,0,6
R_1n1mfLDJz8ZM4Kc,7,3,0,0,10
R_oZGxzSYxVpBfC1z,4,5,0,0,9
R_2y3YmOhNu5eow8O,4,6,0,0,10
R_TtsagKbQzN2E5sl,8,1,0,0,9
R_b42oAzyctrRU7g5,7,4,0,0,11
R_21EzhZnKh2GCXVh,9,2,0,0,11
R_yW6wVNrk5KSgm2Z,1,5,3,0,9
R_2P5VXCXVCGtG954,4,1,3,0,8
R_2DZfEgUaC08yxMD,10,0,0,0,10
R_1kUJb00ZyfeeWMz,6,4,0,0,10
R_28B6uijRiyXHEPF,4,3,0,0,7
R_Rr7Rh2se7gscUCZ,6,0,1,0,7
R_28XLQZxVxMPPPud,7,1,2,0,10
R_dcaX77yn82umoaR,2,5,4,0,11
R_12tkeu8XWB96Vbe,5,3,0,0,8
R_2DMmxA5G0QK9713,2,3,2,0,7
R_1E73TmlSzwMOWYf,4,4,0,0,8
R_232GAjlBQQSAs4w,5,3,3,0,11
R_PzDdEFMhhuTtbvX,7,0,2,0,9
R_3KNozGCjp3Ycv1k,3,4,3,0,10
R_yOVIE930Xn6cRMt,6,3,0,0,9
R_3fZEAcxEWUqJxVg,6,4,0,0,10
R_27jpqaawRMtR9eq,5,1,1,0,7
R_3O3zqzzWTYLOVCg,6,1,0,0,7
R_1GO1UOPZIl2B3Hm,8,2,0,0,10
R_3dLCC21OJk1pjDX,1,4,0,0,5
R_3r1XiEVXmY0usFI,1,3,2,0,6
R_2VmOO2fFcI0NG0j,6,3,1,0,10
R_10UaFSxnpFwh1Hg,6,2,1,0,9
R_3s0sS9Suzp5Uqgm,8,2,0,0,10
R_3qaQNW60yAntvZm,7,4,0,0,11
R_bNpWufiINkKuMx3,3,3,3,0,9
R_yyV1YJNMEluyhNv,2,5,3,0,10
R_28FJX20zYNm8ATz,7,3,0,0,10
R_2VPYfbiSUa0M6Nd,0,3,5,0,8
R_22lRFyAxM3ayyaY,5,1,1,0,7
R_XBvs8BsglKJkuGt,7,3,0,0,10
R_0ohmp2zXfjwbMWt,7,3,0,0,10
R_5sZZL2eLkWFxC4p,6,4,0,0,10
R_1EXv7jzmAoQf9wZ,4,3,0,0,7
R_2fx7wAMWKejolaX,7,2,0,0,9
R_1mDgvIpYreXljvj,6,5,0,0,11
R_UMFzhlOcbDGTtdf,5,4,0,0,9
R_2uNvQBbPqwXUPvu,3,4,1,0,8
R_1P5UHE7ZlUj19NU,5,2,1,0,8
R_241yqsCUKiCxrUi,9,0,0,0,9
R_1kHXtL2NCKOuqvz,7,0,0,0,7
R_Dq1tUEu9mhVTohX,3,6,0,0,9
R_3gZOX3y7Dgd6ife,3,5,2,0,10
R_0UMmpojyTcSVxp7,6,4,0,0,10
R_2TASTO88U4hmTJS,6,2,1,0,9
R_1rf9cFTmkxOyfiL,8,0,0,0,8
R_1mgC2CDGRUwIvaN,6,4,0,0,10
R_3Kw5auGtqogiAox,7,0,0,0,7
R_p4LBDEdqlNQBrs5,4,3,2,0,9
R_12ijzqEsCz3dFRz,6,2,0,0,8
R_3nMF7LsTwr8lP8b,2,1,3,0,6
R_1ISNUvDT9ACUBFY,1,4,3,0,8
R_a3Lb12OeEm4lIZz,6,1,0,0,7
R_1hZnPZmqXKNXjIn,6,4,0,0,10
R_1pYzudfZbNz4aFT,7,1,0,0,8
R_1DIlcPUliHtEoW2,8,3,1,0,12
R_2t3i8pa8iputk3z,3,1,2,0,6
R_VXzsnHlQcgTsmDn,7,1,0,0,8
R_3O09oqwGvnvZUIS,7,2,0,0,9
R_d1ibHDRnXT2rh6h,4,4,0,0,8
R_Uz43c85f3so1bxf,8,0,0,0,8
R_2bV0toTKTm7CRzF,6,4,0,0,10
R_27PZyAwEfsHXYHb,8,2,0,0,10
R_6GqXjDu6sz7Oq6l,5,4,0,0,9
R_3j1K5KHe3aXrwYB,5,4,0,0,9
R_1Lj1LT4IpR48Hcw,5,4,0,0,9
R_27Pfww2JrMZBLE8,5,1,0,0,6
R_2zTkVTdB1I7ItTS,4,0,0,0,4
R_ZlWNkpx1tKEEZtT,9,1,0,0,10
R_3gT67CCCGAmPoFt,6,4,0,0,10
R_3g7QzyKKqPdb1VQ,7,2,0,0,9
R_2atMqBAoO9guU2c,3,2,2,0,7
R_1jpTeDeUFOQpIy0,8,2,0,0,10
R_cAdAf6a9YWcR2cF,6,2,0,0,8
R_swfW9zEa1g6fgxb,6,3,0,0,9
R_1gBj1bDM4nB72fM,1,3,3,0,7
R_UisZW60TlC3mlYl,8,1,0,0,9
R_1i50q8a6xom6zuR,5,3,0,0,8
R_21bRsYevpRshJ1q,3,3,5,0,11
R_1d0rwdQOgOm6LAh,7,3,1,0,11
R_2Tv3GMPu3K2Agtm,5,3,1,0,9
R_10Nny4lE93njzTp,6,3,0,0,9
R_2E60bEybp55B1XF,4,5,0,0,9
R_1Qoxa2B0anI9q2u,8,1,1,0,10
R_3hDB5MtXbZUsLuA,5,1,4,0,10
R_3PCfAKnpcx3VMn0,6,2,1,0,9
R_b3i1Bpzqr6rBWx3,9,1,0,0,10
R_1lazxF2ftIG0VMh,8,2,0,0,10
R_sAvgAAWhWjQLe7v,7,2,0,0,9
R_2rJaDpcKxCRTZam,4,2,3,0,9
R_24ldbJ9KWrlRD3l,7,5,0,0,12
R_2QydoRQmMcQ29xe,5,4,0,0,9
R_1KiNrjQkJN91uON,2,2,4,0,8
R_2CvLfaR00Ms3Ytx,1,0,5,0,6
R_OOlgDbopL0leDId,1,5,4,0,10
R_2wF5HONreDdxaEo,2,6,0,0,8
R_3JaQgdQFduLaynC,7,0,0,0,7
R_1f2fTgH4vD1ifoG,2,5,3,0,10
R_RfcEpylBeXgnMfD,5,2,0,0,7
R_1PbltJFcAMBhvEu,4,0,0,0,4
R_2OGxn9CcVPWU2Ul,7,1,0,0,8
R_2dBmVIOEVmLJMWB,5,2,3,0,10
R_b3F47z716KvusQF,7,2,0,0,9
R_1LogqzNf5PODw8V,7,1,0,0,8
R_uqRJC2SbdejLNF7,8,4,0,0,12
R_2wFY7QRhKnESmDT,3,5,2,0,10
R_2ALMfs71aWoLz28,9,0,0,0,9
R_2PdvtbXmZbEa4iq,2,2,4,0,8
R_2eVlgqjSfCW8Jwc,5,1,0,0,6
R_1Lj7kho2CqMTVnc,10,0,0,0,10
R_31NodhQ1bOjrvck,4,5,1,0,10
R_1M09OuIjBy2n50L,5,5,0,0,10
R_1FkQu7Y7Ro2t2ug,1,2,4,0,7
R_2TuXVCQxeHh0TPj,2,5,3,0,10
R_R4tVETiB2MTKm8F,8,0,0,0,8
R_2assEzaiCAcFPrY,3,5,1,0,9
R_1ojqIsev1fpoLHH,8,2,0,0,10
R_2VBZMbvUQH4kZse,5,3,2,0,10
R_3Ra6ymrF8lN88HP,7,6,0,0,13
R_R2pvNygaM7A8i8p,3,4,2,0,9
R_2q294Ws39rHpxUh,4,3,0,0,7
R_2f3CN39uBlxKkyk,1,2,5,0,8
R_2CwgIH9jFRzYC9K,5,1,2,0,8
R_1Fy5GTwcgv0FjOJ,2,2,4,0,8
R_276Wk3iTlxwdA93,3,4,2,0,9
R_2AQFOHS0c08caYx,5,2,0,0,7
R_2Qth3DuhnJaxcMq,8,0,0,0,8
R_24odwugbBsLNYKs,8,0,0,0,8
R_2S05htLqaAaAxR6,6,2,0,0,8
R_2SvmGzN9jOyy4oh,6,3,0,0,9
R_2DZUP2xmTwdHwgv,5,4,0,0,9
R_3dLmeO64os55sux,2,2,1,0,5
R_2w4alXkeZaJS8cA,1,8,1,0,10
R_12Jdj6W8Z1EFm2E,3,5,0,0,8
R_3EtWnpQ0WU6oKz2,5,4,1,0,10
R_sMtuGREzebOldSh,6,3,0,0,9
R_306PLGsvPXeYXZJ,3,6,0,0,9
R_sUquLtMoDt9s969,3,4,2,0,9
R_23dCuqyWJZu4BC3,5,5,0,0,10
R_yCRPRieCbSDNcT7,4,2,3,0,9
R_1ET7rG9Jwm14kil,5,3,0,0,8
R_tWL8DIXHWrOh34R,5,5,0,0,10
R_3suoxlm18zuOjfU,7,3,0,0,10
R_11gT5J2wiIZTtbu,2,3,2,0,7
R_AEXRA5tSKY48AN3,2,5,3,0,10
R_2UaoiGDOY72CLfU,6,2,0,0,8
R_1Fs656GMZ6YvLAJ,9,2,0,0,11
R_RqbzdkSL7J59i25,6,2,1,0,9
R_3stAByhZWEf3nda,6,4,0,0,10
R_2v8i1NGqnRWM0Iy,6,4,0,0,10
R_2Eabwrd2o96tXT0,6,1,0,0,7
R_2wsEjt1Alhmu7Bl,2,6,2,0,10
R_vruIxpqsaBR16Ol,2,4,3,0,9
R_W34MKJoiynx20o1,5,4,0,0,9
R_3nwTBxEhvTbmCC7,6,1,2,0,9
R_sROsUDmqR93lbUd,7,2,0,0,9
R_UonxnUtklEEKls5,7,3,0,0,10
R_2v870VoKbm0TYff,6,5,0,0,11
R_3gLUlKIiy9qozyP,4,5,0,0,9
R_2zcJCzaDrwx0kqC,3,6,0,0,9
R_AtedIp9vMsFeAMx,2,4,3,0,9
R_AMWaLFORLlLiysx,6,3,1,0,10
R_2sd6FKRkKqUuOQZ,4,7,0,0,11
R_3mk4TSMxAwTo4T4,5,2,0,0,7
R_T5b3QM9UoopUDct,4,4,2,0,10
R_27v39TOHw7jGO1w,6,3,2,0,11
R_3imL1FTEYb6ksIC,2,5,3,0,10
R_27DzfLe1NiZSlGI,4,4,0,0,8
R_3s6Lw8Hnimmm3sc,5,3,0,0,8
R_ywhdD07Pl15UGiZ,6,3,0,0,9
R_1E673ixBE6jE5W8,5,3,1,0,9
R_2SoSojTSGa6mN4Q,1,5,3,0,9
R_pbkgPZ5MSolcCe5,7,1,0,0,8
R_1jALhOusO5xWQZG,8,1,0,0,9
R_1re2ep0bV2hPI5r,4,5,0,0,9
R_1hQrIGHVrB1t7uA,5,4,0,0,9
R_1DnWD3mMPRH78lr,4,6,0,0,10
R_2zBbNvJJRAIJ2aT,8,3,0,0,11
R_8fe0pCmGjNEVEit,3,2,5,0,10
R_1KqJs2KtfnxQWHx,7,0,2,0,9
R_2YFBOyF0bb4yLrY,1,5,2,0,8
R_3JmzGfmiW3YUTXD,3,6,0,0,9
R_padgG2eLdHIpks1,8,2,0,0,10
R_1nMzqfoDAN6DDbP,7,5,0,0,12
R_2q8ZpMP7oYF1Kuq,9,1,0,0,10
R_33xa3VWOsaLxUcK,6,4,0,0,10
R_10GEi6NwDrcyscd,8,0,0,0,8
R_2BaPzE9EnyOqflW,7,5,0,0,12
R_XgMlQmBXduwPBip,5,4,0,0,9
R_5gPbNHqkGhzcPqF,2,4,1,0,7
R_3sae4q1cDbhHpap,4,3,1,0,8
R_3dEWhJYvGDuwJoy,3,8,0,0,11
R_3PHuSt8pWpvIjn6,4,5,0,0,9
R_25yL0kOtRBx0cur,4,4,0,0,8
R_3itfXorCjFEthOn,8,2,0,0,10
R_eaqVzAhyInnCMCt,8,2,0,0,10
R_BzIi23ni7sj1GdX,8,3,0,0,11
R_2dnbVhEtNhI01Qm,9,1,1,0,11
R_1jqA0rtKmUJ79Ad,5,2,3,0,10
R_ZK5yaoJUt4fw0QF,4,4,1,0,9
R_1ihxVnQX5v1UVCR,7,0,0,0,7
R_ekS5Ch4ofD6hVAt,7,3,0,0,10
R_SC216RpZjzHdI6B,2,9,0,0,11
R_1Dp8m1h23243O1q,6,3,0,0,9
R_1gLKbsmSyKic4t8,7,2,0,0,9
R_2EjeXvj4dV4kVN3,5,5,0,0,10
R_R4ug0x2bhbahYcx,7,4,1,0,12
R_3j7M1WJT2TRvSaR,6,2,0,0,8
R_3n66swEzE4qvvn1,5,4,0,0,9
R_XhSUyDxdazEWzDz,3,4,1,0,8
R_2yem4X8EHHe6D3f,1,3,1,0,5
R_3Din8Cxb6ZKk2ni,2,3,2,0,7
R_1JOwS5ogpGqI1Yc,10,0,0,0,10
R_31AxLf35aVMBgMe,4,4,0,0,8
R_2wgZLFqhC97y2bf,7,1,0,0,8
R_AoGwm4cKk9nFd4Z,7,4,0,0,11
R_RV7XN58SeferzC9,8,2,0,0,10
R_1etpPvnChTWrYI8,6,2,1,0,9
R_1qfbQWG680ucjuY,1,8,0,0,9
R_1CkfszTvWRNSpJx,7,4,0,0,11
R_2EFOxomHohAGc6C,6,3,0,0,9
R_Dp275zQtBuJkWXf,2,7,2,0,11
R_3jVby19NU50wabu,5,3,0,0,8
R_AAiG72glHEjRLAR,9,0,0,0,9
R_1FEDptBSGxvmNYC,3,8,1,0,12
R_2ZIT9Nvzfmq15SZ,6,5,0,0,11
R_2YYEj5S0ODFYwN9,4,5,1,0,10
R_22rAHwIhDoVC0aL,8,0,1,0,9
R_2fiXc1D9mYxVBQK,5,2,2,0,9
R_DHKxjXPieSq0Py9,6,4,0,0,10
R_3NV8XQYba5GnQ6P,7,3,0,0,10
R_2tkZgu7qYOxjreq,2,7,2,0,11
R_2490UeqbzcaVC4j,7,2,0,0,9
R_2OI4fFnwYdOnqZk,2,6,0,0,8
R_qW4CROo6P5V1oyJ,3,2,0,0,5
R_3j84qAH0r7mT3iX,2,3,0,0,5
R_1opztKiQNaUXvp9,6,4,0,0,10
R_3NyWZA7oJhMsnju,8,1,0,0,9
R_1gpaEpln0yX9xeD,9,1,0,0,10
R_3RrAVGoAEkQk0Qw,7,2,0,0,9
R_PtfVLMfelNx6JnH,3,6,0,0,9
R_9GlJQor7CU2uJmV,6,1,1,0,8
R_2uWHg1gjiCaMk7Y,6,4,0,0,10
R_2y14vVoxFsN9aRk,5,5,0,0,10
R_1mwoIKafIiUvpc6,2,7,0,0,9
R_1LSe47VUwPtsXwg,0,7,3,0,10
R_3CVPywcEzqsNBOK,4,4,1,0,9
R_2Cy94KY4HQ4b97R,5,5,0,0,10
R_1NyPVS4lpsdgTb4,6,3,0,0,9
R_BVtt1JH6Kxcm57X,5,3,2,0,10
R_1hPWP3BPJT4Le7c,4,6,0,0,10
R_3isaTQQqKVlbN5P,4,4,0,0,8
R_27jvb6Nt9U5Bu4S,3,5,0,0,8
R_1mzlJrw1ZkHEsk1,6,3,0,0,9
R_3dLnP9LKr9KzDmB,7,3,0,0,10
R_2wsmUGk0mhzShtG,4,4,2,0,10
R_2CE1ZK8bcaFiJJf,6,5,0,0,11
R_XpTVIaUQPduS7x7,7,3,0,0,10
R_2YPuqSYhTFPL3m3,2,5,2,0,9
R_1q2kF5xb0wU8Gg4,6,3,0,0,9
R_1g1kEnUoXCtj1en,6,3,0,0,9
R_22Rewig0qIMN3y8,5,3,0,0,8
R_3niL2p9taD3TfFm,9,2,0,0,11
R_1rCumCWJnRUKbis,8,2,0,0,10
R_1OpEKIVDyHhRPLX,2,5,1,0,8
R_1q4kOeoC5QSFXuX,1,8,1,0,10
R_Tq4zVeT5WbzoZ5T,5,2,0,0,7
R_3iDzABcuQzAhqWc,7,1,1,0,9
R_1LGYgNqWEUbLBbw,4,1,0,0,5
R_3Oc8NFuYYJnEYYz,7,2,1,0,10
R_szFL75jVrvrEkyl,9,1,0,0,10
R_3Ga0ibUe7aDzqpm,6,2,1,0,9
R_215mw0DYIYipWg6,3,5,0,0,8
R_3CIURW6FEoJTYn0,7,2,1,0,10
R_1mlXFlW6WV7bCx4,8,0,0,0,8
R_2saITnXZerpn0Bf,5,2,3,0,10
R_vCtL0toPR8QinDP,2,4,0,0,6
R_1hS7b8yYWBn07E6,6,3,0,0,9
R_3NVPx4EK1CVBOgD,0,6,2,0,8
R_1ghlacLlQyJDtza,3,6,0,0,9
R_bws0I5CeHCABaKd,7,3,0,0,10
R_1JIU7tKH5YZOxS2,5,5,0,0,10
R_xatws3EJ1okd9Qt,9,0,0,0,9
R_1pG9QMSoSL2kufi,5,5,0,0,10
R_12ltzpFf0D2Jcql,1,2,4,0,7
R_BM0Hk4QPWRSFUxr,8,2,0,0,10
R_1oIsEOnGXKFbUGV,2,1,2,0,5
R_2bVpZ9fHqLyqiYR,5,4,0,0,9
R_2sYHDXpE2uyJ8Fo,8,2,0,0,10
R_27yAIasfdcdHnPE,2,6,0,0,8
R_NWMaBWQuDz3rytH,3,7,0,0,10
R_Q0c46brHhlurt7z,5,6,2,0,13
R_2YJuEtmJzXrFOm0,6,4,0,0,10
R_10pFwY701UmKXCc,4,3,0,0,7
R_2q2C1PduuxxtiWS,3,9,1,0,13
R_3GcUkvyTMHREkel,3,6,0,0,9
R_1jiBIG3CQFe2zeM,10,2,0,0,12
R_3GuH36PSYjJAOE0,2,4,0,0,6
R_2uHtVTmApiYMw1s,4,6,0,0,10
R_2DNQv9yp36PO9O4,6,2,1,0,9
R_NXYF0buQ7Kyy0dX,0,1,5,0,6
R_31FcQuPQ5sAjBb9,5,4,1,0,10
R_spaMoctlRizzNkZ,7,2,0,0,9
R_3fJN35AkZq184Qu,4,5,1,0,10
R_1liymsRiNJChK3w,4,1,3,0,8
R_Z8XhrXeLcBkB7m9,5,2,0,1,8
R_vDgekhVH8y5RZeN,6,4,0,0,10
R_1Q5CXOGHFAtAYrY,6,3,0,0,9
R_2f8QmYVK0O90lbm,5,4,0,0,9
R_2c0zcE8rHAgeEvZ,9,2,0,0,11
R_3NSzTGIfqNh6lm9,8,2,0,0,10
R_2EHuyl5ofR7yhIy,5,3,2,0,10
R_24pA7VL0NxpkHI0,2,5,3,0,10
R_2YYdsJKZDhaf2SW,7,1,1,0,9
R_3qfE7PGdHMq9x3j,3,5,2,0,10
R_2cd9l4Ze6BDERC2,6,3,0,0,9
R_1gIUZ7Nct2O5GLN,8,2,0,0,10
R_2CCetWARbCghOV0,4,1,1,0,6
R_2t3f6JSZKTq4Hgf,0,8,2,0,10
R_2xJCsXpFIgFFiDJ,4,5,0,0,9
R_3GEg13iyCzb6lik,8,2,0,0,10
R_1rvmdcKKls4SSez,5,3,0,0,8
R_3kcENnymCmsKyjG,4,4,1,0,9
R_1OJLCRGmjY3VncC,5,4,0,0,9
R_2zr9TIZSXmaTSkD,8,2,0,0,10
R_1P6JodHhx3JQq2y,9,1,0,0,10
R_WwBGHZvrh8HGX1D,8,1,0,0,9
R_2wjg8vVT9RoIWDl,7,3,0,0,10
R_6uoizyBxmljcHYd,7,3,0,0,10
R_1KcKOMKb4Ei91Ee,5,1,0,0,6
R_1CdvLgGANYcFXVo,7,4,0,0,11
R_5dmW0mFZ1Fj4g6d,8,2,0,0,10
R_1lsLSYcDJuaJUIw,2,1,5,0,8
R_1o4HJNDIjZ02OUt,3,4,1,0,8
R_3RxUdcX6WNhsvj0,4,5,0,0,9
R_1oqlrOW8XNYlpzx,0,3,7,0,10
R_3gXfzOoEkDHgSTI,4,5,0,0,9
R_3jdu6mtIEYP3pTT,8,2,0,0,10
R_svzPpk96tPC4Rep,6,2,0,0,8
R_28IJVn00WuljOte,7,4,1,0,12
R_2aQXImqbfiWI2z6,7,2,1,0,10
R_26qdo4UvsH2TYoF,5,5,0,0,10
R_2Pegn30pU6k17p0,7,1,0,0,8
R_OkB43VXMKGgNQEV,8,1,0,0,9
R_22s1ww1fXkgCcR0,5,0,0,0,5
R_129Y3yyr8glQQay,7,2,0,0,9
R_3n78RcEclm1tfC2,4,5,1,0,10
R_0lJvetqfFJDnu8N,5,4,0,0,9
R_2OMHotTmO4iGvXp,3,5,3,0,11
R_2YKVoHv9DJEPHnq,6,2,1,0,9
R_vuFexiUoPaEHHS9,9,1,0,0,10
R_PFJY9O1yZNzNgL7,8,2,0,0,10
R_515wvls4h3uGwDf,2,7,0,0,9
R_31dwFe05Df1ZGxd,4,5,0,0,9
R_3jfwShrdQQO4sqJ,5,6,0,0,11
R_3MJAhijp1F0Wxzi,5,2,1,0,8
R_uyw56pg4PxTONOh,6,1,2,0,9
R_3DtZylfuOeKirM6,6,6,0,0,12
R_1JDv4rKOftvzEut,3,4,1,0,8
R_2SwwrV7RIh1terq,3,3,4,0,10
R_2X55R90ZT5p7mC1,6,3,0,0,9
R_3ey2bxMMY4uEXtN,6,4,0,0,10
R_xaczHrhE21QJYu5,7,3,0,0,10
R_DeIab9gWuBXdUml,4,7,0,0,11
R_1FJnzelBDJdFkAQ,4,4,0,0,8
R_10PMuCsfOTtUgdF,5,5,0,0,10
R_1ewVKfiXNmDtDP7,7,4,0,0,11
R_yDDHXO5jd6Qic6t,5,5,0,0,10
R_2uvrP8HDuoiOEDK,8,2,0,0,10
R_2VL5lxePPHaNyfx,7,2,0,0,9
R_27VW6VJ0lx8WTgq,5,2,2,0,9
R_w7Wmhv9RTOtg4JH,1,6,3,0,10
R_1l68rTaQmILxGCB,3,3,2,0,8
R_1l9MMtzyr8m8XS0,7,2,0,0,9
R_3lz4qG43pxFDguG,4,3,0,1,8
R_11dyCdnxmdz1Xug,7,2,1,0,10
R_2rkFM32lQwLiBVP,6,2,0,0,8
R_C8KRJOy6FZWNN85,5,4,0,0,9
R_0ibd6NKMunx9AXL,4,1,1,0,6
R_3ixaOC8ezMTGtVW,4,6,0,0,10
R_1DLOQfwJFeJzjVe,3,4,2,0,9
R_3FKbBpXQEG1Mejp,10,0,0,0,10
R_1BSf7cczlYE84mK,4,2,2,0,8
R_3oI3QxNroZAijBe,7,0,0,0,7
R_3qPOtTlmGIxwovf,3,6,0,0,9
R_3ggsEA2hiZgWBCp,2,4,0,0,6
R_3ezeVPiXqqehgdV,9,0,0,0,9
R_2v8F5TGBJFQiBDD,7,2,0,0,9
R_1l5HTfy5ZMfQnCn,8,1,0,0,9
R_3JC2KJGXSHfWSrp,4,5,0,0,9
R_31bnZLHh7vNQPaa,1,1,7,0,9
R_3fE3hKZM0g8EUPk,5,3,1,0,9
R_3EndysPYJWzTOj6,10,0,0,0,10
R_RaE568mans2KtkR,3,3,0,0,6
R_2DN7mLMxOBNAOEF,5,5,0,0,10
R_07HmRIy7FvQIJVL,4,2,3,0,9
R_0HupvU7f2dbQ77P,9,0,0,0,9
R_3O1V8Jyk6aY7PlS,9,1,0,0,10
R_ah0HRmY3Ld3blvz,3,4,0,0,7
R_1HhIIZR02vj4XVb,5,3,0,0,8
R_1oGTGaT2jgkOtPC,5,5,0,0,10
R_868ORPW1aEncg8N,5,2,2,0,9
R_37NX4irRMbAuQ4V,2,4,4,0,10
R_20UVUr24kEUPWX8,3,3,1,0,7
R_2tKhiQ72uqITwDG,5,4,0,0,9
R_3EWskLloukTGjxj,4,4,0,0,8
R_3EZ0kgkJtllKAlW,4,2,4,0,10
R_1Lii1Wlal0t83FT,6,3,0,0,9
R_3M4FAKEBRHPx7K0,4,5,1,0,10
R_2s5fDtgCVJEPSTd,1,6,0,0,7
R_AKYVL6l7t1w8DPr,0,2,5,0,7
R_1LTnZ6AHbbULbaC,4,4,0,0,8
R_28HaWeuf5D036Yd,4,5,0,0,9
R_2Bmp547BiNtOoAI,9,1,0,0,10
R_31BKXProtBBXevU,6,3,0,0,9
R_1QKiUc258yxmMlf,8,1,0,0,9
R_3iCln1e24fU1Xzc,2,0,4,0,6
R_ONGBiN3QyvVLCJX,6,3,1,0,10
R_2t0d7cSs8BQVoLB,3,5,2,0,10
R_2duLzXBoOjncVnG,7,2,1,0,10
R_2Cp5jgLIL4TGta3,8,1,0,0,9
R_308kRdkAlrXTVr6,4,5,0,0,9
R_3jfxrt0WDlu3oU0,5,4,0,0,9
R_D8Lwf50AlHMZ161,11,0,0,0,11
R_3lR0JWkpWZIWaSH,7,4,0,0,11
R_2AZqKw4K3LhFrAJ,4,4,0,0,8
R_27CM3mtjO8jztJj,10,0,0,0,10
R_1pXXIzUaYJECwd6,3,6,0,0,9
R_2v1BfcDXhWsnfkI,3,2,5,0,10
R_3DikcAzB41Stdgl,10,0,0,0,10
R_1lAFP3OLoVhdDyp,4,2,3,0,9
R_2q8IaHwuU1CQ4Qs,3,2,3,0,8
R_YYRksUU7oviwWIx,8,0,0,0,8
R_1mrD03SnTKZKiSV,5,1,1,0,7
R_2zbBmshByD65XyL,4,2,3,0,9
R_3lFHZWSfqUVHJ1h,7,2,0,0,9
R_300s0ITfeyg4Xwg,6,3,0,0,9
R_bQ8xWTnlythz54d,4,5,1,0,10
R_28CZTOHRAEVWI0G,5,5,0,0,10
R_2CBaVLipD5ZtZGM,4,5,0,0,9
R_2duQ8Ss5jq6PU0E,8,1,0,0,9
R_6Q2CtxvXdCtm5hv,8,4,0,0,12
R_2ctEFcYsVjzWU6i,3,1,4,0,8
R_blusDAXHliNTKZr,6,1,0,0,7
R_1C3ebpiYhed6lGU,2,2,6,0,10
R_1jNbXAN5pz6fxVc,6,3,0,0,9
R_1P0l0MKCTVtOqX4,0,0,6,0,6
R_XnymCxPUUOCSpUd,5,3,2,0,10
R_1kGqqiJ34K4rlf4,5,1,2,0,8
R_2DRYIrUIfHhkvPO,6,3,0,0,9
R_77cXPNhCmEFlgIx,3,3,1,0,7
R_XiCHz20vS1ZRkS5,2,5,0,0,7
R_tDMncYVqDiWHhqp,6,3,0,0,9
R_22MkGyJPmUCGEUJ,5,3,0,0,8
R_12eUKRwT1c6QhJp,7,3,0,0,10
R_1jx4pAV11duX1PF,7,3,1,0,11
R_2zo8BR2irrhFJTl,3,6,0,0,9
R_27Jy3ZDFrqwja4m,0,9,0,0,9
R_1jjEOFyytQMoU4p,5,6,0,0,11
R_2Vmh3PlmqZ55pIv,5,3,1,0,9
R_1et6vgqapePKi06,5,2,2,0,9
R_31HiYb467ga6U9m,6,2,0,0,8
R_3NOPqB31zgisqRa,5,3,0,0,8
R_3fdDKoVw70CHRdL,4,4,0,0,8
R_b9tfFLg5bVfqFLH,3,4,2,0,9
R_31FBo4okgqsNMbr,7,5,1,0,13
R_3ErLwpNlJxMG4e4,6,2,0,0,8
R_ahgwoNybwCSEUMh,7,2,0,0,9
R_eQibzcGMNfhQC8p,4,4,1,0,9
R_2BtbiHhEz4Uo6yx,5,4,0,0,9
R_1OSJC02eVmn8ehZ,7,3,0,0,10
R_1rvtPWJUCdrs5Xt,3,3,2,0,8
R_UA9GuH6koQmC3vP,5,3,2,0,10
R_1C6ZRlB2yK416iW,6,5,0,0,11
R_AoJANSmxdqLcEw1,4,3,3,0,10
R_1K86dUmSrR4XrkJ,9,3,0,0,12
R_3fBN6vZTBhXpDIc,5,4,2,0,11
R_1gU6ovfmiJMzXjT,4,3,0,0,7
R_XHYySBibNCJPYdz,5,5,0,0,10
R_bDDHeWw8GABIXeN,6,4,0,0,10
R_3kLpmGOdrywSeBg,6,3,0,0,9
R_21aJScGPiMzxrbL,7,2,1,0,10
R_3ELlFuBmXRthxFn,2,6,5,0,13
R_1JD59fD7LdBYlIm,4,1,3,0,8
R_1JVoTSswfVSwTEq,9,2,0,0,11
R_Y99NkLaquizEP61,0,8,1,0,9
R_bjYSSt7b9wMuQV3,7,1,0,0,8
R_2To7NRhRhiQTS9R,7,1,0,0,8
R_1G1Pti6i4ZIzZeh,7,3,0,0,10
R_3k802A9qtmINIWq,2,6,1,0,9
R_1hYiwciWydL3kDA,7,5,0,0,12
R_1DN1hTfUkbiAVyV,7,4,0,0,11
R_1n8X7Q3qrWnLd42,4,2,1,0,7
R_zUXPqFrjRfehFaF,6,4,0,0,10
R_3IcwQudzNIrc5Xb,7,1,2,0,10
R_1Crw1Rbi3mTDmtg,10,1,0,0,11
R_1rMmS7yGczlmerV,3,5,0,0,8
R_3fMEx8tC4YACgTO,6,2,2,0,10
R_bq2QoEjjByiMpsB,1,7,0,0,8
R_3QK4lwZDmXJujaR,5,7,0,0,12
R_27x8dxah4BgVq9q,7,4,0,0,11
R_Os3CI2NQvZhvgwV,5,3,0,0,8
R_3G19iiaMDjQ0jmc,3,3,0,0,6
R_1P6mCBvzsjNJ5xU,1,6,1,0,8
R_1NCC8SZPzvodXcg,4,1,2,0,7
R_1DIRA6y0u1xF4AO,2,9,3,0,14
R_1CwKHAid6QdzyRO,7,3,0,0,10
R_1gw1egC5YWWqkDe,5,0,5,0,10
R_3EcZ7WQAU6ENHJD,7,2,0,0,9
R_2Y648Q6m8sDwz7S,2,0,7,0,9
R_1msaUfcBQqxwmIt,7,5,0,0,12
R_bCw1bBohKE4iBd7,2,7,0,0,9
R_1eFZOmzI7zvkRGf,2,1,5,0,8
R_115vatZHace2tff,7,3,1,0,11
R_2VBJdb2TitpJQ2J,5,4,1,0,10
R_AgFCw0hwZWPpLON,4,4,0,0,8
R_2YgPwUFrouJLNxn,6,3,0,0,9
R_3huSTmkvqgsSNaZ,7,5,0,0,12
R_2dub5CtazxlbDCl,7,5,0,0,12
R_2rJGMrukNwFqmMX,8,0,0,0,8
R_1LdJD20Sma4urwk,2,2,5,0,9
R_25F7cILhhLxVEwL,12,1,0,0,13
R_Om5Ay4CgzCH9uaB,4,4,0,0,8
R_WCGZdvjBd9wpQs1,7,2,0,0,9
R_2OIokQxrQEANHpV,7,3,0,0,10
R_1riVkBUCFcflIue,9,3,0,0,12
R_1j8NOiIAIRAssdn,5,3,0,0,8
R_2CPbSYoDTEGoDLl,1,6,0,0,7
R_2CfuJhdtpdbXvDb,7,2,0,0,9
R_3rZD0eMVnTNuYsI,2,3,5,0,10
R_pgVauJPyfzuV8o9,3,7,0,0,10
R_1OrAk0eEEl6YJzB,0,4,6,0,10
R_3gXvL4FIBMgLjmS,4,4,2,0,10
R_1mRDQGL8FJ7XiTn,5,4,0,0,9
R_b45YKexwlRR432p,4,2,1,0,7
R_32RBUjGB45bxtXu,4,7,1,0,12
R_1OMJCs0yFrIn85C,4,3,3,0,10
R_3plmj7TP5UMj6wH,5,3,0,0,8
R_2cuN6jsJvpPWBt8,7,3,0,0,10
R_9uwyLZMG8yLJ6tb,8,4,0,0,12
R_tStgYyNu3gdDdwB,1,3,2,0,6
R_1GGlLQjc57Wnr7b,6,4,0,0,10
R_3kijB7o4xraDHJ6,3,5,3,0,11
R_1Ehf4cWIadqlOFg,1,3,6,0,10
R_1KdsXuFnPdgnMGB,6,5,0,0,11
R_vehxeu0creFDuzD,7,2,1,0,10
R_33a58d75I1YrBuQ,9,1,0,0,10
R_2rVN1iQKkbFLHsw,5,1,1,0,7
R_3QzBRYrvpX8i4xj,6,4,0,0,10
R_1Q9DbPzrmeM93xw,9,0,0,0,9
R_12z3uiX9iYjhqpO,4,3,1,0,8
R_2YQewSn68WeMTHv,7,3,0,0,10
R_3HMIsvE30G2ZMer,3,2,4,0,9
R_1HeiEx64iuVRZwO,9,1,0,0,10
R_A5SN0Mw7WUzJyFP,5,2,2,0,9
R_s4OZbpbU6EANBvz,5,2,0,0,7
R_332MFhNEums64jo,7,3,0,0,10
R_24paS4Y4gJD2yyH,7,2,0,0,9
R_2amzTTIjsXwoEWD,1,2,2,0,5
R_ZDYLKlpdJEZzv21,6,4,0,0,10
R_wM0QIfdOd3KrYvn,7,0,0,0,7
R_3qrEaMYelM0bUpr,3,9,0,0,12
R_2BqFlA94YYYKIdy,6,1,0,0,7
R_1n8RkoIFOuWXluv,2,6,0,0,8
R_3I03M8epcl7gbGj,7,2,1,0,10
R_3fDxNwCZXEc74LG,5,1,0,0,6
R_XiVFbkzdWXxqCsN,3,1,2,0,6
R_1EhE2x1gyUylZUG,7,2,0,0,9
R_RtujIq9PiZI5Un7,8,0,0,0,8
R_3PYxe8eNU4MjmlH,3,4,2,0,9
R_rlJeRBxfv1j70ul,4,3,3,0,10
R_C4GS0l1XBOoGOch,8,1,0,0,9
R_33dIu46QkAwaFSO,8,5,0,0,13
R_1jJP5Mts2Scy1dt,4,1,1,0,6
R_3khY6RVnrt2SFhU,4,5,0,0,9
R_2VgaKkXRhPyrZVr,1,4,4,0,9
R_2P7qi9NRaVsETM4,6,2,1,0,9
R_xx3SdYqsC0j9Fux,5,2,3,0,10
R_XTCJqOhkzohnYCR,5,6,0,0,11
R_1CKnSp8ihWx2VvU,2,1,5,0,8
R_wLfYnO8XQtSj4Qx,3,1,3,0,7
R_DBO3AYZIVGsHeAp,7,3,0,0,10
R_26bb5OIZSZMSABu,4,4,0,0,8
R_1kLVsYVdWaDDZgR,6,1,0,0,7
R_1IW9TvsG5dYw4AI,1,2,4,0,7
R_2X5O3sZt64syrgP,3,5,0,0,8
R_3ef2e15BqldiVUv,7,2,0,0,9
R_3OfhVSMkEkCS2WN,6,1,0,0,7
R_2ZBLFpjiDsbNdoh,4,7,0,0,11
R_1ZdM9yP9aipobvP,2,5,3,0,10
R_3qmTECxb64fDvGW,5,3,0,0,8
R_psjTesam6XWNg89,6,2,2,0,10
R_3QQVDZXcPjwS7ij,5,2,1,0,8
R_9sODimmqeJ1FXVf,8,1,0,0,9
R_25EB5XGU2XV3Eu1,1,3,3,0,7
R_1kFxDWyz1syF6le,3,4,3,0,10
R_2aDCNCcF9jyudAG,5,4,0,0,9
R_2whpResIupE8A8I,9,0,0,0,9
R_1i87Avl2Xz40xTE,6,4,0,0,10
R_3iWijergmnkiYz5,5,6,0,0,11
R_ZeNqRxhzQKKMcWl,4,1,2,0,7
R_2uyLQyiT8hJCDXY,8,1,1,0,10
R_9XMTkzt034FoUHn,5,5,0,0,10
R_2aIY441M8hCikix,5,3,1,0,9
R_1DMvxJbNuL5U4Fq,8,4,0,0,12
R_ZwRRzWxvCteRPRT,7,3,0,0,10
R_7WpBhKguNjig43D,7,2,0,0,9
R_1DqDFbmkthXumuy,5,1,0,0,6
R_2EuCM1Mh2y0CEgY,0,3,2,0,5
R_3MtJM4MfkNHRS9E,2,2,3,0,7
R_3dEXg7jV4YJvTEd,4,4,3,0,11
R_etYkyWlssgtHdw5,3,7,0,0,10
R_2wa7R38UmalLPQ1,5,6,0,0,11
R_3FIZHKKJG8fO0Ga,4,4,0,0,8
R_5inAyrCnh7jIdDr,8,2,0,0,10
R_PHximdgaZ7eASHf,6,3,2,0,11
R_2zdsqHeZuY4kP4d,2,10,0,0,12
R_3nCREtmbdzuXASD,1,5,4,0,10
R_31EhdqrSZ2XaTri,3,4,0,0,7
R_25s88Cm8WC86odF,9,3,0,0,12
R_3kOrtDXdL2QLqfU,9,0,0,0,9
R_25HCqiPf2E37fPN,3,5,3,0,11
R_Zf4mIYpGG30o785,5,2,2,0,9
R_2zBz5RxPejQabka,2,6,1,0,9
R_2YWbuQy4rz9NUpU,5,3,1,0,9
R_pAahqTYp9CRUS4h,4,2,2,0,8
R_31T4btrO7KMzD41,2,5,1,0,8
R_2WMxyWoxLdcyRrO,5,1,0,0,6
R_2aK4nDGp8CluAp1,7,2,0,0,9
R_1dmZv8lTePzL16F,4,7,0,0,11
R_1mek5miSd485PyI,8,4,1,0,13
R_1CyicRrOFDeWeuC,4,3,0,0,7
R_2fD3QaWgmsmZYzf,6,4,0,0,10
R_25BkKAPdLGK0CMr,1,4,0,0,5
R_3NQmBB7UndIv8hK,6,3,1,0,10
R_2XbObnzde02TDcl,2,2,4,0,8
R_3HNgPAh4zidVPUC,6,5,0,0,11
R_yrnV3owmIhrdTih,2,5,2,0,9
R_2z6Fll6GMZsROnU,5,4,0,0,9
R_3oFW9JO73Pk22q0,8,4,0,0,12
R_1EWgq02i0wRijOA,7,2,1,0,10
R_3GldPDAUNVm3Gg1,2,1,7,0,10
R_3MhWfY8A2uJ6JMR,5,3,0,0,8
R_3eaWZYFO5DBzTNz,6,4,0,0,10
R_1NDKoylHpuAheNa,8,5,0,0,13
R_2f9k9zO7C5Ax086,5,5,1,0,11
R_VQnW8oju3JMrqw1,10,0,0,0,10
R_3rID8xh9F6l7ep6,7,2,0,0,9
R_3EEzf7dHjzpUOSP,8,0,2,0,10
R_26eT2rkzSOf1d0d,10,4,0,0,14
R_UuQbvgghCdjQtoZ,5,4,0,0,9
R_339VWffbeGhSbg7,5,4,0,0,9
R_ZqpkKAIjXtlana9,3,4,1,0,8
R_1rANBzXWMJiCACL,6,1,0,0,7
R_3KvCJWD38D62dUb,5,5,0,0,10
R_1l4ZTEvvTmoAVAP,2,5,2,0,9
R_1oBEsqgvVMzyk82,6,1,0,0,7
R_2eXTy7UTQ7EMd0l,4,5,0,0,9
R_po5X5OHG4VhP2Fz,3,7,3,0,13
R_YQ5zODohzhykcrn,0,5,5,0,10
R_OeQdVtpNs6kb1br,3,1,6,0,10
R_3PT4eqpcB2Is4R2,4,4,2,0,10
R_1FICOO6ANrPmnOO,7,3,1,0,11
R_2TKVcJXimmGcGU3,8,2,0,0,10
R_1B8cWJ06AfEUIAF,2,5,1,0,8
R_etygMT9dKTkQkut,4,1,2,0,7
R_1hFqgS0OrG1lXoA,2,0,4,0,6
R_3JIehXY3QyqJcpP,5,2,1,0,8
R_3dXhkU5lp68k2rA,10,0,0,0,10
R_295oWfzBE6P5oZb,5,2,0,0,7
R_2iymGIvnmqZIOD7,6,3,0,0,9
R_1mt4rcittwm9lTg,7,3,0,0,10
R_vHQVpG1neofy4PD,1,1,1,0,3
R_ueL4oiYBPSBYd5n,5,4,0,0,9
R_2B3C8cSrPNvwyAt,6,3,0,0,9
R_300in8Abbju7zKb,4,2,2,0,8
R_2wgbEVSx7ZsDUDA,4,0,2,0,6
R_D6NKln3bDIfI2cN,4,6,1,0,11
R_2xKm8SkPv8xOuhe,7,3,0,0,10
R_1C3GPNj9PjJeAO5,1,3,5,0,9
R_2uKaTGTEjcGMFOb,5,6,0,0,11
R_1NgAV2dhTGZR0oX,7,3,0,0,10
R_OfJ5dSBCNkfsR3j,5,3,0,0,8
R_2ri4A3k0N1xSwKf,7,1,1,0,9
R_2TI8Gix3rzUdgQ8,6,4,0,0,10
R_24OV9pxTmJ85RRb,5,2,1,0,8
R_3qsXLZavIW3XgxY,5,2,0,0,7
R_2xJCyftnj5rsLMR,6,0,1,0,7
R_OsbbEtv5cN6n5Cx,2,7,0,0,9
R_3q7CWDF2B4Rmo5A,4,6,1,0,11
R_3MyUwwcP3sQIjos,2,0,3,0,5
R_1LvbtUmAhdxdNml,5,4,0,0,9
R_1erALkixHIrEFxn,8,2,0,0,10
R_2fAQ7Hl3DTa7c2O,9,1,0,0,10
R_3G9u5OOLBxOIa2e,5,3,1,0,9
R_27vXHae4WRpwEih,4,5,0,0,9
R_1F8MuAY4rDjcL3C,3,3,2,0,8
R_238h6Rt3xtfvYU6,8,1,0,0,9
R_2tops4bOCvHS9ZJ,1,2,6,0,9
R_1LtECZPtbrJx5Ey,7,2,0,0,9
R_4ONKjC7Cd470hoJ,2,6,0,0,8
R_1Fn8SoQCrdW2rvW,7,1,0,0,8
R_3Oicdc5GlHV0dAO,4,4,0,0,8
R_cBA6f8cKJ9BJb0Z,7,2,0,0,9
R_3lM7XCu9EnvnXGX,1,3,5,0,9
R_1ouLNHmH3kVGroo,1,6,0,0,7
R_1Fm4JDqo80efzwA,7,0,0,0,7
R_2aWFOFet4tvR8qz,6,4,0,0,10
R_27rDZF64JhmKdaV,3,3,1,0,7
R_bwIVWmwdfJHpjaN,5,4,0,0,9
R_2ZJIB6Q1IOjInjs,5,4,0,0,9
R_3kI1GVboWj9q9ws,3,1,0,0,4
R_3oScyygCVwtt3PF,5,4,0,0,9
R_1Fbsgkl2vorIH8b,3,9,0,0,12
R_12eZKl0ABibkes2,9,1,0,0,10
R_u4lizdx6Dlg1Or7,6,3,0,0,9
R_1oimHCEcr8Ypl0e,5,4,0,0,9
R_3D6fvkOM6NweeRk,6,3,0,0,9
R_6qZ5opMcVTIUxzj,1,2,7,0,10
R_Du9kNAWOyRt453j,4,4,0,1,9
R_2TKHLXASRBdfzzc,3,3,2,0,8
R_3ffc8YJkeNv99Hg,4,5,0,0,9
R_1eJLVoIDv3S4qEk,5,1,1,0,7
R_T7aj6AX2bKwRYBP,8,0,0,0,8
R_3rGLHyveED01AFg,5,2,2,0,9
R_zehEmA46KGLQmmR,3,2,1,0,6
R_WkbFZTsuEgArO13,5,5,0,0,10
R_2cdqMTouYp5y2TR,7,1,0,0,8
R_UGWXjtCzhLdi6dj,1,5,2,0,8
R_DSJVnUxOtVAnCdb,5,1,0,0,6
R_b13ewU7EVDUW2Xf,7,5,0,0,12
R_5nxDblMWBZR48al,5,3,0,0,8
R_3dL01yNTKL65OCN,6,1,0,0,7
R_3QDacQuKjJYt0nk,0,1,3,0,4
R_1pyWa7BsSazUD3c,5,4,0,0,9
R_DoCRTOf65vRMb0l,7,1,0,0,8
R_1hGzDGcNVrvK9NM,8,2,0,0,10
R_3kqczXY1y0rTWbc,9,1,0,0,10
R_2sSTnaYnAqPoAwX,1,4,3,0,8
R_1eUHfuqidPdRDtK,4,6,0,0,10
R_3MG1wrz7w2GnZxp,12,0,0,0,12
R_3Ny4bLTdZCcJSl6,4,4,0,0,8
R_2BnUCGi002brOxv,1,3,4,0,8
R_vN1v1tPKLAwg7iV,8,1,0,0,9
R_1GCzFfaw2JMyMP7,4,5,1,0,10
R_yViQeEdgKKZAmzL,6,0,2,0,8
R_pyCRW5863vsc9gJ,4,1,2,0,7
R_30tLW0y2XF0bofz,4,6,0,0,10
R_3hrpVTw56WcN3Te,5,5,0,0,10
R_1pYvQaesLXWROd6,0,6,2,0,8
R_enBRfuDcQtnmRuV,5,5,0,0,10
R_2ceKMKMuD7eOC2w,7,2,0,0,9
R_1mIC1VM4eX9SJ8A,5,5,0,0,10
R_2DRzy38yKzY0s4R,9,1,0,0,10
R_1FkpbWaqCuZgN64,7,3,0,0,10
R_R8JI6gwKbiG12ud,7,4,0,0,11
R_1mCKpovKzVKyBHw,4,6,0,0,10
R_yNJ98jSga5Enwu5,2,2,1,0,5
R_eS3h5P4FAJMIaMF,3,0,0,0,3
R_1gMzvH9ZVqxiDhu,9,1,0,0,10
R_12y8PndWbYf0oBF,5,5,0,0,10
R_3szWMTK3zM1HlXg,5,0,0,0,5
R_Dw5AvqssNaNSrHX,10,0,0,0,10
R_2TXeoVD3yiY3DoJ,0,10,0,0,10
R_WjLgdfDqqHHEs5X,7,2,0,0,9
R_2atPjPdZUjvbtj2,4,2,1,0,7
R_3lQYcX7rJrM9lo7,6,2,2,0,10
R_3CK0z5gxlTRswfj,6,2,0,0,8
R_2EtWyecHHxc0ey0,5,2,0,0,7
R_1hRo1R5vUqV5KD6,5,4,0,0,9
R_1GT9b2iZd6PTDql,3,3,0,0,6
R_2CPOimw5U764hr9,7,2,1,0,10
R_1nTn4PjArUBMqjS,0,2,5,0,7
R_3MojRbwvvuwZgnA,5,4,0,0,9
R_diIpiuzFuWBzIbv,5,4,1,0,10
R_2fq6IA7L3GSFBlm,8,1,0,0,9
R_3fT34uUzXhyouGU,4,1,3,0,8
R_Q4YVxwbU8jkkEzn,5,3,0,0,8
R_11d6tV4OurGnWgW,10,1,0,0,11
R_3smhlE6WhIHVJ4x,7,3,0,0,10
R_AclhCVnj1xoIOop,2,2,5,0,9
R_cZRBS5kil3uR0dP,5,5,1,0,11
R_3J4WBdjZwzEzqEU,3,2,5,0,10
R_3QXms00WpAKxEQW,6,2,1,0,9
R_27vvdOh02wpANFd,5,3,2,0,10
R_ywG5QGMUeYRLlWV,8,3,0,0,11
R_Cdxl49RrVn0vCAV,6,3,0,0,9
R_xu8AZXe4LEvxMt3,9,2,0,0,11
R_3e2bJFtdZO8de0p,7,3,0,0,10
R_Clgxl7710e3XlsZ,2,5,2,0,9
R_3G3s4s4IHrPP35G,6,3,1,0,10
R_1jKdZbYuJMBsGhw,5,3,1,0,9
R_2tnHBsBvm8jHwiZ,8,1,0,0,9
R_2ixnCQVfPyqAMSt,8,3,0,0,11
R_3J8XNxRu74g06wr,6,3,0,0,9
R_pQwJeGSFkhljmgx,4,2,0,0,6
R_3HGlLVK64B7nfyv,5,2,0,0,7
R_4Gbup4a4SXKv39L,8,0,0,0,8
R_Rh6Q1Lm71tbZ321,5,3,0,0,8
R_3JKQr2xwpKadzaE,5,5,0,0,10
R_55Do96IPwMbr4cx,5,1,4,0,10
R_3NWkEzNWzsYrKN1,1,1,6,0,8
R_1qeyowEPqCJ7d5P,5,2,1,0,8
R_1kUDfmfNkB4AUE6,5,4,2,0,11
R_3oXGMKk0D5A4FPe,0,4,4,0,8
R_1MKZCkkAG0WgLcN,3,4,2,0,9
R_2dRuT1QOtOT87TO,7,3,0,0,10
R_1P00dtIHATQL63q,5,2,0,0,7
R_PSvU9MsZuCSKyUF,4,4,0,0,8
R_x42Vcp6DFYJuzw5,8,1,0,0,9
R_2wABnFAtWKUK1eg,5,4,0,0,9
R_1nORvEBao8vSRTf,3,4,2,0,9
R_245ISqE2r2MIwOR,6,4,0,0,10
R_2YfDI8aoAIoBWkv,5,5,0,0,10
R_QhyLzk2xlO80rFn,7,1,0,0,8
R_57nakWBeoMvSVyh,6,4,0,0,10
R_2TmJchNrbIo1JW1,8,2,1,0,11
R_2dR5DGWgjwZ8bVi,4,4,1,0,9
R_2S7aW52TKjOUYIe,5,3,0,0,8
R_3neeY743rvJ4zFk,2,5,2,0,9
R_6y7z9mg8NtAvmdb,9,1,0,0,10
R_2YY95v9aVS3GI5L,7,3,0,0,10
R_C4gHSBFBgDqWcIF,6,4,0,0,10
R_2Vm6fT0EbJdkXeU,5,3,2,0,10
R_2atzBpHhFCNbF0x,7,1,0,0,8
R_1DG7CzMX49bRaeu,6,2,0,0,8
R_2c8ceKfZPIjaRMe,0,9,0,0,9
R_aaeq5xl2fqBurSh,8,3,0,0,11
R_bauLaLVpb6V7Gkp,5,5,0,0,10
R_PA2cwHa9yXWGZeF,7,2,0,0,9
R_3w6luwPfgTQ5Vo5,7,2,0,0,9
R_WlHbqDWGw4VGTfP,7,3,0,0,10
R_1gzJevKVu8dLiBF,1,5,4,0,10
R_29bqaHlL5auvVhQ,6,4,0,0,10
R_3CJxbswOLIlfso4,8,2,0,0,10
R_129MaFt92somuoM,4,6,0,0,10
R_3XhjP6eDG32SuAN,6,1,1,0,8
R_1CvaOHyTYrSAv7g,7,2,1,0,10
R_3RvzoPhAjt7bNGQ,6,1,1,0,8
R_3g5YWpvZcaq4Pgy,9,1,0,0,10
R_0pwY8g9TiabI15D,7,2,0,0,9
R_3FViFngiZcvh97k,0,2,4,0,6
R_1pPQbStxwVIKrw4,5,3,1,0,9
R_3oTHhmOCjehkw8W,4,5,0,0,9
R_1otHCZ3buTSNb9z,5,3,0,0,8
R_26gbuY8hy2lXALG,7,3,0,0,10
R_3HYLeucE4gW9GaW,7,3,1,0,11
R_2f8dSCqCrUk87vj,6,2,0,1,9
R_1IbA5IIGgKnSoAr,5,5,0,0,10
R_vTFdN2kmPHx5kIN,3,2,2,0,7
R_PHhcDCJkvySP3Wh,8,2,0,0,10
R_3gNmgMmlEEBky6n,6,1,2,0,9
R_b9DJRG14lfilSfv,4,5,0,0,9
R_1l3G6kj7uum0yzd,5,3,0,0,8
R_2YyT6xETcwCO4yr,5,0,0,0,5
R_2VL4GC7o03zMidX,6,4,0,0,10
R_1pX74YVpHWKhEkp,9,1,0,0,10
R_1BOWbq0w6g6prmx,4,4,0,0,8
R_3dX1a95LMrOUnUG,2,3,5,0,10
R_2bhHXopNdalsrgR,2,6,0,0,8
R_2nsPmhncjB9fOTv,4,5,0,0,9
R_25F76qmnChH1RGT,4,6,0,0,10
R_9QTWcuNit4au1B7,8,2,0,0,10
R_2tydmQ1as8pCmOl,11,2,0,0,13
R_1ZkwEpNrTT2jiCd,6,2,1,0,9
R_1Csx3ewmMg0Xuol,3,3,1,0,7
R_1lzxC5DWFuIwymn,7,3,0,0,10
R_1jxnJqUSYM9YlfG,8,1,0,0,9
R_cMkVhqoaWtHKTTz,1,3,6,0,10
R_1gAAtWGf13EK1gx,7,2,1,0,10
R_2uJMnuB6KzuICEp,7,1,1,0,9
R_w5zkGBYdlS9Qr8B,5,5,0,0,10
R_2PgHGaEUzeihdB6,7,5,0,0,12
R_2xKlJncnEmeZSpp,5,6,1,0,12
R_sdpBx7XgaWCaaFb,5,4,2,0,11
R_3sBJVz8QsBND0Jl,7,2,0,0,9
R_1OPmINum7hORenn,8,2,0,0,10
R_1GWBeB2XMMfi6mV,8,1,0,0,9
R_3HXHROPjSTQzqTF,8,2,0,0,10
R_2CWIWo47lt1ePTb,4,1,5,0,10
R_2zSEnKrSDNxFMkq,6,1,1,0,8
R_Dc0soOCvb08hrs5,0,4,3,0,7
R_1MTbINc8hOCOFWm,3,5,0,0,8
R_3CBmDY2MQ8Gvmqg,6,4,1,0,11
R_3PB78Xn5kWV9qkV,4,3,3,0,10
R_323CghRcPzDBCtD,3,2,4,0,9
R_R3NzyZWintw0oRr,7,5,0,0,12
R_3iOR4A4JslnXyIE,3,4,0,0,7
R_2nrnzDazRRkxALD,5,9,0,0,14
R_3qxNTtgbWXo8Ptd,3,5,0,0,8
R_RF6hPsUtCZVcT05,6,2,1,0,9
R_3MFgBaGOwInoypi,7,4,0,0,11
R_sjM5399SaQL6EcF,7,2,0,0,9
R_1ilBPEozTDy4jsG,9,1,0,0,10
R_2DLEHS9MxRBR1Hq,4,2,2,0,8
R_2zFT99A2TrrDX2c,4,4,1,0,9
R_31i31zyJiJqfaAS,6,2,2,0,10
R_3j88DC3ntihQJii,9,5,0,0,14
R_DMIiU5b3uiCuHrb,6,3,0,0,9
R_3qaJFwkLPKuk0pr,5,2,1,0,8
R_22QXuLlK9znyyAe,4,6,0,0,10
R_2ROqp7YZ6u87EYf,5,3,0,0,8
R_2cooHUy3LFl9amA,8,2,0,0,10
R_2cC9HgioxtIByzG,7,3,0,0,10
R_1mpXkLKxeT2kUJE,7,4,0,0,11
R_UMzRIeIKo9MHtip,3,3,0,0,6
R_2feW5YN9SNGCc3X,5,5,0,0,10
R_21byfWYmSWKVTYR,10,0,0,0,10
R_30qShKeSIeSkuPe,7,3,0,0,10
R_2uUkdxcfw1BPbTO,3,1,4,0,8
R_YWwlo4x9Iw3QnkJ,0,2,5,0,7
R_26fNlflLuNAsEuv,7,3,0,0,10
R_w73f07yUavkESsN,2,2,4,0,8
R_294TSBkP2U3HbJU,6,4,0,0,10
R_ykGNlEABsfP6aaZ,7,5,0,0,12
R_25SWyiYP2u3YLy6,5,1,2,0,8
R_b2iOPa5lMIvQ1xv,7,0,0,0,7
R_uaDJXCs1RR9C0Rr,6,3,1,0,10
R_XM54crxetReqfPH,8,1,0,0,9
R_Dvl04E2qXMBBKMN,6,4,1,0,11
R_3ph9M9cm7AbOofr,0,0,6,0,6
R_UPH6xDGUFVSy4kp,9,0,1,0,10
R_29UNQlybqvM5kSl,5,5,0,0,10
R_2QMMEjNeAuJVKip,6,4,0,0,10
R_3nc2yZRg2cyE5d0,6,4,0,0,10
R_1E6iMfuwYJPKAFO,9,0,0,0,9
R_01J2w8Bgrsr7SIV,4,5,0,0,9
R_1eFPG9PJ6u9ge1z,7,2,0,0,9
R_yZOqONwXsYH6qDn,5,4,0,0,9
R_1gC79OORtOSD8dZ,5,4,0,0,9
R_31EkekVAoORy6w0,4,3,3,0,10
R_1KexZkQi1xIKUW0,3,7,1,0,11
R_uaH2tLwbYsWUCgp,4,6,0,0,10
R_rilKqBr9hQK0GzL,10,0,0,0,10
R_1LXTU7dhdIt6pnz,1,3,5,0,9
R_2ZCGmUuBOKg40sp,8,0,0,0,8
R_3s52zx14Bl2zqc1,1,8,0,0,9
R_9yo50DLYByCEqRj,0,4,4,0,8
R_vJqYYj0jHAEaA3T,0,0,8,0,8
R_2xP1VXqv1MbAfFA,6,4,1,0,11
R_3JCoEpHOJsgQClr,2,1,5,0,8
R_21dqKzp5xf6aprI,7,3,0,0,10
R_1gkmvlIbqu5BXTh,3,1,1,0,5
R_3qm3TZDtyc6WRXC,5,4,0,0,9
R_pDTVJ6YDFpO3s1r,6,3,0,0,9
R_RFvrodnvtDvVwRj,3,4,3,0,10
R_1q2nL1TWcJtxqml,5,3,0,0,8
R_0Glf2sN07qQocpP,4,3,1,0,8
R_2WtZuglbuN1Yhrr,9,1,0,0,10
R_PFqcpL3fMqpkgRH,3,3,2,0,8
R_1GAZLR06V2emibO,1,4,2,0,7
R_1NlEV3kIoO3lZcU,5,4,0,0,9
R_r0HDUNQqdR3bj2N,7,2,0,0,9
R_3EhCAeWra4gJbcM,1,1,6,0,8
R_CkTakXJMFULBadr,7,1,0,0,8
R_801eADxKyotjbLH,7,3,0,0,10
R_3KI3k5g63mFlJup,5,5,0,0,10
R_UnBeT127KPSPVxD,3,1,3,0,7
R_29od7sToMwg34vZ,5,4,0,0,9
R_SYOuH338lM3UL05,6,3,0,0,9
R_SNpxAjYP4QVHLz3,6,0,0,0,6
R_2Bxt0csX10mX1A6,5,2,0,0,7
R_3Ej9PeNdt2uAvlD,5,3,0,0,8
R_RmhH7g3jj0HYEQF,4,5,1,0,10
R_10qQMgJZG9SV1jt,6,2,0,0,8
R_DdBUMuujpEZgErT,4,4,0,0,8
R_2TzO6Wr7Iou1wza,6,4,0,0,10
R_294dNyrMyfuZTWT,2,4,0,0,6
R_doPNIr53EvksiFX,5,2,1,0,8
R_SC1yzgFgo2ETOlb,3,2,5,0,10
R_3iVETFI3KgeDwx5,7,3,0,0,10
R_1gtFoXK8GGnzITt,7,4,0,0,11
R_TpX2i8AQzRe6p9f,3,7,0,0,10
R_tStu50LuJR8GuxH,4,6,0,0,10
R_1FD1xAKFPjykkGS,8,0,0,0,8
R_3HXLqYJocAqnEP2,7,3,0,0,10
R_3LbCh8SQdYDxNF6,7,3,0,0,10
R_1OTrXumwfdlBmKk,4,4,1,0,9
R_1Q3mn6PtCDrolEn,6,2,0,0,8
R_2sXOhaJXCcQ2FuU,4,5,0,0,9
R_ebbdwIFsKK0aonf,6,2,0,0,8
R_1SOvFPaDnudH8T7,5,4,0,0,9
R_3KNgWp9nJNF4aQN,3,3,2,0,8
R_29h2yLa8JPA1Zjy,8,6,1,0,15
R_Tw74CQX2Eu0H1TP,5,4,1,0,10
R_2ZP9qtU4JjUqhIP,8,0,0,0,8
R_2DTcFLXyKdDPetA,7,4,0,0,11
R_2CEdO4cmzQDBSac,5,5,0,0,10
R_1JClYpZq5rJ1drE,2,4,4,0,10
R_30hKaPymtZmmzzD,7,1,0,0,8
R_3fkPMBlxagpnu4J,5,4,0,0,9
R_qF7kOlrvat8vS2R,6,3,0,0,9
R_3oYBmTw002cm4hR,6,1,1,0,8
R_Op7Ezba4nAf8XYd,3,7,0,0,10
R_2TXfJe71GuaxePr,9,1,0,0,10
R_2qmcS6RGV1wZ3jI,5,3,0,0,8
R_XBVFXPhZRIWRNLj,3,3,4,0,10
R_3DjQadRaYIQ7BPo,0,3,0,0,3
R_3NEPxxkNkPnvHn2,2,5,4,0,11
R_3KxATIJoBD9POUM,3,4,1,0,8
R_3MFl0RtHpy0w6IJ,5,3,0,0,8
R_2E6KRnELikPswor,6,4,0,0,10
R_s7KR7N4Ghx3RHgZ,6,3,0,0,9
R_1liAQ2HJovm1wcB,5,5,0,0,10
R_1NqD0eUSrx5rcGh,5,2,3,0,10
R_2ZOHgsqPAvj8703,6,2,1,0,9
R_PA7Ki9JdMLeqUZr,8,1,1,0,10
R_XhQ2Eobzb1cdTcR,6,3,0,0,9
R_1QbDKHCmlPyf5Ag,6,4,0,0,10
R_2uxpqeYMld7Gd6S,4,4,1,0,9
R_11Zr3FLaupb3nrz,5,4,0,0,9
R_cU7Aci8fyYQ8GlP,2,5,3,0,10
R_djpogB2tLDPEY4V,6,2,0,0,8
R_2f9UBOPHnV5paYS,2,0,0,0,2
R_1pKdC00wZXa0lCi,6,4,0,0,10
R_25L8Kii303CiTLd,5,2,1,0,8
R_31L90JgL8o6ZUdc,3,5,1,0,9
R_3lW7uZ6jkX25BG0,5,4,0,0,9
R_1rBL65o7AjiKYR0,3,6,0,0,9
R_3m4DHLwhvxc9coe,2,3,1,0,6
R_uyr8pCIEhlc90dP,6,4,0,0,10
R_2BxFgbohO2zTUwp,4,8,0,0,12
R_Tqgy7moGumzDQEV,4,4,1,0,9
R_2ANguP72xRz0OT7,8,2,0,0,10
R_3e4YshAgPTEiv0N,7,3,0,0,10
R_1oor47auSDv1yBZ,3,5,3,0,11
R_3hij22lOwo0113q,3,7,0,0,10
R_2rInrIll15Q8Jib,8,3,0,0,11
R_2qjxw5E79VbhSC4,4,1,3,0,8
R_tL3eUGutqrg327L,5,5,0,0,10
R_3IWuJi2dtQpJs6g,1,1,5,0,7
R_1PXGC8lifwpANq3,6,2,0,0,8
R_2BeCcbGACVbHZxd,0,4,3,0,7
R_31TxjTDVvNiEspo,9,1,0,0,10
R_2rkAcIefUzUbsCl,3,3,3,0,9
R_2eR4vKUCJ8nn9t9,5,2,0,0,7
R_1QmVwkZwH8dFsN8,5,2,0,0,7
R_31SEZ8LPq1xD1Ll,0,5,4,0,9
R_1nZJUDoEroD0MYT,11,2,0,0,13
R_Uc0sQ70Jdnzv7SF,2,2,4,0,8
R_3J7Z3Tdo50RQSgf,4,4,0,0,8
R_24JmJeJH5jntPZb,7,3,0,0,10
R_3oAyu9zZmV8FmMH,3,2,3,0,8
R_0cv8iyjveeAYeQ1,4,4,2,0,10
R_VW3vBE6JmZmqiGd,6,3,1,0,10
R_31c2TJR9xjbqcxn,7,3,0,0,10
R_3iEzl08KZGzFFTQ,9,0,0,0,9
R_3M9HvY9RqimFqeb,7,0,1,0,8
R_1rlwjq3vjPSv4nw,3,6,0,0,9
R_0oHP8sYcPlLqHap,6,1,0,0,7
R_vUXjwQy0AKq6L8l,7,1,0,0,8
R_XgC7ZI9tcb7bZKx,1,3,3,0,7
R_TcKQYZkHn9RRJJf,2,5,1,0,8
R_3hDXeqfmXXGtsil,6,3,0,0,9
R_cMknJeXkF3T0cVz,8,0,0,0,8
R_10oBuqGBo70IFBU,4,4,0,0,8
R_0Dj9DeWcVaQOeDn,2,5,2,0,9
R_bjcEpOZ3l4mI14R,7,1,0,0,8
R_zd7AwvUKEpF7vnH,3,4,3,0,10
R_PSAk13Up9GXyDMl,2,5,1,0,8
R_1KycOIKtXLytXiG,9,2,0,0,11
R_pLd2uXbz7HaQt8J,4,4,2,0,10
R_2dEXE8bB2l5TBVQ,8,0,0,0,8
R_yBYqDq9kMPWjO49,4,3,1,0,8
R_12gsdHwCOXETm1V,4,4,2,0,10
R_wL5IwNUGKmPy1eF,7,2,0,0,9
R_2WUAAZchsKa5zjn,4,3,0,0,7
R_3maXOIaPygVO602,5,1,2,0,8
R_1flawthJFuwuRjE,2,4,1,0,7
R_2uKwW8D3dBsoLzn,5,4,0,0,9
R_do6d25FMdMWU0q5,7,2,0,0,9
R_UEgaJKUWHcpcWgV,4,6,0,0,10
R_2scgr69z7UFsaE8,7,2,0,0,9
R_3Pu8IK7vIkj089g,6,2,1,0,9
R_2QVC4M0cAZtdMYY,7,2,0,0,9
R_2EplaPm8OLWjyrm,5,0,2,0,7
R_1jeowoOK316f4MZ,6,3,1,0,10
R_2Ph81XayQSML0Ly,5,4,0,0,9
R_22nsIwmT7kyBwgH,2,2,2,0,6
R_2sUeUuukivqplre,2,4,5,0,11
R_UMGWBihLR77NCW5,8,1,1,0,10
R_57IR1e66AaWxfIR,7,2,1,0,10
R_2aWHJMF2iZuF4wF,4,1,4,0,9
R_1Igd3aT5TxUMHgj,5,3,2,0,10
R_2zYCOWphz141B3O,6,3,0,0,9
R_1riDJPiOTMIKzyW,3,3,1,0,7
R_WC1ULhOp49kY32F,8,6,0,0,14
R_SMCT6nWu7yJcpO1,1,8,1,0,10
R_3KBiQ4pKS47cQXp,3,4,1,0,8
R_1OxjBhASsDK0yp0,6,4,0,0,10
R_22DjtuQnglnBb7J,2,2,5,0,9
R_77phLvtNq49POlr,7,2,0,0,9
R_1ihAXe6wfRWAveC,7,5,0,0,12
R_1mzzhc9qY55hNSy,8,3,0,0,11
R_1hHhULmnMsBgvzi,9,1,1,0,11
R_3EbVy6oFYW3xlZJ,3,3,3,0,9
R_2S8GnbN8ut1OeAk,2,3,4,0,9
R_1BQ2O7B4HM45HPb,4,1,4,0,9
R_1OHVzZ9FdPKVZyE,5,2,0,0,7
R_3nDeZvgK9Ou2HI7,4,0,0,0,4
R_bkNOZkjqgZ6Ong5,2,9,0,0,11
R_2rqfiA3qWPvqXH8,3,4,1,0,8
R_Y5DugyHVMz9A7El,6,2,1,0,9
R_2t9iVpZoQibTh3G,6,3,0,0,9
R_1OWeAw1f8N8dm5J,2,7,1,0,10
R_10NV3LlJgprMa9Y,4,4,0,0,8
R_PG3DgaEg5vO87cJ,6,4,0,0,10
R_3fwbUJwFdkwNlRv,1,5,2,0,8
R_3s09u1o6g408vhn,3,5,2,0,10
R_10xsmE7pDcw2UyB,5,4,0,0,9
R_4ZoipvSqor6LajD,4,5,1,0,10
R_3Jz2WNctbcDSVPP,4,3,0,0,7
R_DT6U6tJGyBHf6lH,8,3,0,0,11
R_1cUgwBB6bJPzaXK,6,2,0,0,8
R_yCFRoj1Fw57dl0R,6,2,0,0,8
R_24bYLyV2mPadjWf,6,3,0,0,9
R_1eruZzHrE6HVSm4,3,7,0,0,10
R_3nouBxUQftX9bH4,5,4,1,0,10
R_tL4BAxJyfJwoKhX,5,2,2,0,9
R_3NEzMXw2jvysGZ8,4,2,3,0,9
R_3HYQWrojCyEwudr,6,4,0,0,10
R_3rYf6dYLdG7BcfK,3,2,4,0,9
R_2ZQEFyKoralNUuW,8,2,1,0,11
R_24hENnFappFJ6Sy,4,4,0,0,8
R_1okh2FeRSwml2zy,3,5,0,0,8
R_3GuIHuKO3kPnfno,6,2,0,0,8
R_RsQYT0CGKAmNqtH,7,4,1,0,12
R_2wRZsc4ToBRBFNs,3,7,0,0,10
R_1HkJbaucIfLKYl0,3,6,1,0,10
R_1kFZV7PK7rKYPX7,0,4,4,0,8
R_1E4da0cYN1XYitu,3,3,0,0,6
R_2SCAuZl0nz8Mlru,4,7,0,0,11
R_cBxlSSzAIIDvgdj,6,3,0,0,9
R_2dLm778vO9NbrKY,6,3,0,0,9
R_ZwPj9KM3eXrFVap,7,2,1,0,10
R_3CZTPRZTYKFuGAg,7,1,1,0,9
R_3avfbWelKfak5hv,6,2,0,0,8
R_2B5kuT9HVLOP2ok,7,3,0,0,10
R_w12dXOca53qjzB7,1,8,0,0,9
R_1jUFYTmmhSjbuon,5,4,0,0,9
R_1LwyLBFL6SMj2Jg,3,7,0,0,10
R_1lz38gM65bQWjyF,8,2,0,0,10
R_2CgqG1jYvjLMRBc,7,2,0,0,9
R_2uNzMcggsbjU4zB,8,4,1,0,13
R_2pPG9s8v1psLFfl,3,10,0,0,13
R_2Pt0cpUHmoO00eq,6,4,0,0,10
R_3dXnL5Xw8hp9zA1,1,1,7,0,9
R_1DA6eVQHMQWEMDS,7,2,0,0,9
R_3ptcm3ZvFbs3bBh,8,1,0,0,9
R_vieNnGiOVgNXDKV,0,6,4,0,10
R_1QsjpTSBt78dHdD,2,3,3,0,8
R_WpVtTTngN1EAdYR,7,3,0,0,10
R_1gNOMLTB4Wdpk1Y,3,3,3,0,9
R_1jB7aMcuwuxtK6H,4,6,0,0,10
R_1jprVQnoUrIN4Nq,4,3,1,0,8
R_3EgbyebqeevZKLU,7,2,1,0,10
R_27JC4Hboko1UOGw,6,5,0,0,11
R_22QWUnsfrhDEYQ8,7,1,0,0,8
R_1IsA4u0ZD41wcNz,7,2,0,0,9
R_5gAnY1VO7b1zoE9,6,1,3,0,10
R_cZIKIMOIdxmZi2l,2,1,7,0,10
R_2pMq3KeBuQVf2HN,2,5,0,0,7
R_2OVy0zLV6Fhy0dZ,6,4,0,0,10
R_1eIWiN57l23kBkq,5,4,0,0,9
R_3GE4ZzVJ7FY5hro,5,3,0,0,8
R_1BW2MiSr5AmjZBw,3,5,1,1,10
R_1LuGO2inY6OumJS,4,5,0,0,9
R_1oCtYyG69GsLkCt,3,2,2,0,7
R_3VtBv0zHuGMorBf,6,1,0,0,7
R_2ClWHBQSZHfvUlz,7,0,0,0,7
R_1jkp3uZAVu0YmKv,7,2,1,0,10
R_sqiXfFtt1RKZWuJ,7,3,1,0,11
R_27DViR7LjypsI1O,9,1,0,0,10
R_1LXrIqTQC5Bp0Er,8,2,0,0,10
R_WjQWARjnGMsoV6p,7,2,0,0,9
R_1lsCDMddiasWh31,6,3,0,0,9
R_2wppMyXLP2fZzeP,4,2,0,0,6
R_11Ye30Wfy7wKLix,2,4,2,0,8
R_XmOUFYW3XamXgDT,0,2,6,0,8
R_2ZCS11c2iNblLam,5,5,0,0,10
R_1hXPLvvsOncZJMk,5,3,0,0,8
R_1oeeGMTAHCdU67D,1,3,2,0,6
R_2duss5qHITqMDpY,6,3,0,0,9
R_OeZUxaliGMlbU4x,3,4,3,0,10
R_1LwA7A6rymAMwwJ,6,3,0,0,9
R_esa884IYuEuyK9X,9,2,0,0,11
R_2zcKSU3qa4nshkI,7,5,0,0,12
R_2ceH8W9rBofmB2z,7,2,0,0,9
R_3D1MY5O7bgh6o0m,4,4,0,0,8
R_2ZQXKOK7E7hPHyy,1,2,5,0,8
R_oYT56pVKM06BiNj,4,3,0,0,7
R_cTOrXKiUzbfVjeV,3,0,7,0,10
R_3qX75U6weOgCbGK,7,3,0,0,10
R_UEXPmndMUG8F1eh,5,5,0,0,10
R_22J7qrReNX8gWXN,7,2,0,0,9
R_2eWDG3B9LbYoyUq,0,6,2,0,8
R_URx0bDBvIaBT1aF,5,7,1,0,13
R_yI9gkgOgQUS9I6R,3,6,0,0,9
R_3n2fZAKVOB2FpqO,3,4,1,0,8
R_3KBp5VHKNcP8mZH,5,5,0,0,10
R_32Qv40GOu9K2m26,2,9,0,0,11
R_tSw9yHw90x4MpAR,4,5,0,0,9
R_5BYeexpKgsqaJAR,4,2,0,0,6
R_3QKpSSyC1ydOKyo,6,4,0,0,10
R_237arokmtW9sU7H,5,4,0,0,9
R_3Krsh8RUdZNEJSk,1,5,1,0,7
R_1ItTXyb3QtWNhXo,3,3,2,0,8
R_3HHOqlSDVwEez2x,3,5,2,0,10
R_3I46sJWhkdeuphz,3,6,0,0,9
R_56VOw280Y00vJ73,2,6,4,0,12
R_sdKaJ2cvnGF60cF,5,6,0,0,11
R_2q4yn4IhGeNed3a,7,2,0,0,9
R_09eszuXMfUUhle1,1,5,1,0,7
R_3oRzhziCTpik3Rw,5,3,2,0,10
R_2dBdfRAvoeett1j,4,6,0,0,10
R_pJW5C9UBZgFDI2J,6,1,0,0,7
R_1Kx4FtxWWbapxp4,8,2,0,0,10
R_1rPscXyqdWMmMKV,0,4,0,0,4
R_12upGkigtFGdiJw,1,3,3,0,7
R_qC7x1zb1UwS98fn,4,2,1,0,7
R_Qok7i9jqE4LTfuV,4,7,0,0,11
R_1Dw110t9Y6Eb7rN,1,2,4,0,7
R_24wnTYbGfAp7frM,2,1,6,0,9
R_2WuPtBgoJDW32rA,1,5,4,0,10
R_2Qta1KtXjZxq5fO,5,5,0,0,10
R_6VBwVSFeauPdjj3,8,1,0,0,9
R_3CTSwRa5SGWCJlN,3,1,1,0,5
R_1M3RYum4XQLOSeB,7,6,0,0,13
R_UzLPbuRVCIsFK7f,6,4,0,0,10
R_3ik8XBnTWQJEZHf,6,2,3,0,11
R_OiI8RauwJQxPzb3,7,2,0,0,9
R_2v8tEzwM8BuYwpj,4,4,0,0,8
R_2qDdeTH9ntp4dsT,5,5,0,0,10
R_WeQXEjPXHKFlTSp,5,0,0,0,5
R_3Pjyf6JLzb04iG7,4,4,1,0,9
R_338seP8uvAOHl1t,9,0,0,0,9
R_R9Mc7d6dYsarRIJ,9,1,0,0,10
R_1DoHDLjnVOoZJg3,4,1,1,0,6
R_3DvHvv7CZN309Ni,5,5,0,0,10
R_28D5y4Nz0MXAgqI,3,4,4,0,11
R_d5zc9YrjFZqTNM5,2,2,3,0,7
R_2SepJRjeHwBEMnh,4,6,0,0,10
R_06t9Zu1503Mn2kF,2,3,3,0,8
R_TpcRph2QaeP7SZr,8,5,0,0,13
R_1f8Eix16itPEq0A,2,5,4,0,11
R_10Vp3R0yfnuzHYl,5,4,0,0,9
R_V3aeXC12Hfcudax,6,3,0,0,9
R_31NUA5pqGKH2GtJ,9,1,0,0,10
R_3jAvNpDBRSdxYvT,7,3,0,0,10
R_3HRCbkjLZnYfYup,8,2,0,0,10
R_WqjRtqrIOUjBFdv,6,6,0,0,12
R_3n8b3WoNYD08mmL,9,0,0,0,9
R_1Cw4QpusD8xbx1y,6,4,0,0,10
R_3lz8V4AKaUkpwiB,5,4,0,0,9
R_4NsXDCFRW9yBXrz,0,3,0,0,3
R_12tFz05dMs2dc0p,2,1,1,0,4
R_DeFgIJBn2tYjLpv,1,4,3,0,8
R_2Rb1aSYiLoU9Iz9,2,0,0,0,2
R_30e09EZ9aQcGprj,0,8,0,0,8
R_3iJ8Q8MdOKVpaO8,7,3,0,0,10
R_3hiIZIep9KsmJc3,1,0,1,0,2
R_5AqNEA4GzfWJclj,8,3,0,0,11
R_2fd6bklAawJMKmK,1,6,3,0,10
R_1rOzS1IdnEl8NV7,5,2,0,0,7
R_11dc4oOSB48tAcN,2,5,1,0,8
R_2TSjnblSfK3yZdG,9,0,0,0,9
R_C8tfK3IdNMZZ9rr,10,0,0,0,10
R_1hWmM4sLtHYcMet,2,4,3,0,9
R_1OBs9xy9gOuBAvg,3,2,3,0,8
R_82oUcg8Uo3MH1lf,7,1,0,0,8
R_3Hog7qcii9Tk3YR,6,1,1,0,8
R_28MXulUzwF6kVXL,4,8,0,0,12
R_3nOYOqFsh44j9X2,4,4,0,0,8
R_6xPZLYtQItl8hEd,3,7,0,0,10
R_3kcXbVkVuqEfMpp,6,2,0,0,8
R_Z9NOlcY7bmciM49,8,2,0,0,10
R_1pGAoKTHs6MYCng,7,3,1,0,11
R_0PozgXxS49qSxtn,4,4,1,0,9
R_1NePTUnLp3WZzNc,6,2,0,0,8
R_2TuBO1cReKzgiaI,6,2,1,0,9
R_sZraSyNNaaoOmXv,4,1,0,0,5
R_3KqGtW2C8I0WMsk,5,4,0,0,9
R_2DRIeXT8llrYhK8,5,4,0,0,9
R_8raTcZDqQhuEqY1,5,5,0,0,10
R_1QcuntCKOoIjTih,5,0,1,0,6
R_1ikRK3u4rOXWJRw,6,0,0,0,6
R_1pR2sjLNsss6V3C,6,3,0,0,9
R_2CjMqbGoQqGbUQC,4,4,1,0,9
R_2CUKwg6nyy2whzx,6,3,0,0,9
R_3egbZbPZ5lXX0s8,6,3,0,0,9
R_3PUiwSfQ98uswEK,6,2,1,0,9
R_2VR31Ff0G26Cx7p,5,3,0,0,8
R_23ennAMgCaCXXMW,7,0,1,0,8
R_1JQiV0gMeYZ90Sj,5,5,1,0,11
R_AMdS7B7csV8pEGd,9,2,0,0,11
R_CaGNCNdx6tTN64p,8,3,0,0,11
R_1QMfK2ZxKaohCHT,1,2,5,0,8
R_OwXUdTiX2Us8Llv,5,6,0,0,11
R_31zRwCQ0WkWywXj,4,4,4,0,12
R_1r1gsi2hKzFNPXq,6,4,0,0,10
R_tSpIoGqXv12L8PL,8,1,0,0,9
R_3QVoSse8H415fK6,6,3,0,0,9
R_3PjBGTohNldinHS,6,3,0,0,9
R_1pyxbG2v050ClOz,5,3,0,0,8
R_1pZ5KDLaxTeyVCc,4,4,2,0,10
R_3PiaAO3AfuAk54s,5,5,0,0,10
R_3EJUxXBNd1Khqtb,7,1,0,0,8
R_1oqlZuTWVVpXUHW,8,1,0,0,9
R_AvNusAoGRSpnl7j,9,0,0,0,9
R_OjpYsTMaiKXIbSx,3,3,2,0,8
R_31AEsYh8yUi6auK,1,5,4,0,10
R_738HK4wHCk6xDZT,7,1,0,0,8
R_1latoYvILIrTI68,4,7,0,0,11
R_4OqXMfLOvhqW2ZP,3,5,2,0,10
R_bQOUBumMHU9pdjr,3,5,0,0,8
R_2fJq7e1y4FhOTbY,3,6,1,0,10
R_1f9lj76WF6rguaQ,7,3,0,0,10
R_DbH75Khbyqqn4E9,2,4,1,0,7
R_r7SraPPRJlO1kc1,4,5,1,0,10
R_bEjlpnPCudIQqBj,4,4,1,0,9
R_3fBnYCZvOjWrN7r,7,3,0,0,10
R_3IRmJl0duSakNAs,0,3,6,0,9
R_RfUnd1rLt2j60Rr,7,1,0,0,8
R_3KHNtHCEXx1TZJ6,7,2,0,0,9
R_aeFUeqqv1g6Hdip,3,7,1,0,11
R_3fcQj4xB8AGFANP,3,6,2,0,11
R_rqgEiXHdUXfKIlb,6,1,1,0,8
R_2areBu5NLKt4CLp,8,3,0,0,11
R_3j1dTeSJVPmm73I,2,5,0,0,7
R_1g14nsMUtMaAdfp,9,1,0,0,10
R_UlFRIVRnIN6L6p3,2,5,1,0,8
R_2Y4UpACESryRmHY,2,3,4,0,9
R_24LWspAt72wLbVZ,7,2,0,0,9
R_PHUvOri47utHbnX,8,3,0,0,11
R_1QfJu4rxmntZmDv,6,3,0,0,9
R_3KSZzCn1NUpkkrB,5,5,0,0,10
R_SJ2zXXSaiurZ9rX,2,3,2,0,7
R_1DBFlsi1lpu9TmC,4,4,1,0,9
R_2YmgZGIkrQCCeSZ,4,3,4,0,11
R_2ZBx1xOnu2jVeGY,3,3,2,0,8
R_2QKiQq8bOHpvzyX,5,3,1,0,9
R_1jKi0xXRNAKdCZ4,7,3,0,0,10
R_21cgZdrrqAtJiZb,5,4,0,0,9
R_3GfccZ9WP2jA9wG,5,1,4,0,10
R_2qsh3y8knmNpAe7,3,6,1,0,10
R_12ArZ2Bp3KtmhSP,5,4,0,0,9
R_2wigy0jI4PmaQXT,7,3,0,0,10
R_2EFgMby6M81Ebs4,6,4,0,0,10
R_2YeTw8WXPx0MgvI,5,7,0,0,12
R_2c2cKsPjuYtoppg,6,3,0,0,9
R_2AGTxqV1d09BJOG,8,1,0,0,9
R_1DRPwk2EsNJVo6s,5,1,0,0,6
R_3qmqFYwkBvQLylX,9,0,0,0,9
R_3qtOTaxMtRIcbdv,7,0,0,0,7
R_42xEapWu9pDf997,5,4,0,0,9
R_1FOLazozg2IsrtS,5,3,0,0,8
R_2RUIWDhNEtpovJg,1,1,3,0,5
R_1IH7lzkjthvbXtO,4,6,1,0,11
R_3hzNdei74amzHbQ,4,5,1,0,10
R_1E3R5Ydi1ARCPAx,1,5,2,0,8
R_3s5ij4eh0Yyf1sh,5,3,0,0,8
R_28O1GJ1OwcfAV0w,4,3,0,0,7
R_2sT49sXL2GLGFSQ,6,2,0,0,8
R_1KdKk7wxm9TsS6Z,1,3,2,0,6
R_1FLABMUtusop2Ip,1,5,1,0,7
R_3PsCz2VmOMeujJC,6,5,0,0,11
R_3nqnfC4wBVGmEpX,8,1,1,0,10
R_2xCP5hB3DIH493C,7,1,1,0,9
R_UPBWXXgG4snOxzj,7,1,0,0,8
R_ptPETPzR4kekakN,6,2,1,0,9
R_21mNOynb2rGSZUn,2,3,2,0,7
R_3GcBc4sOih6W3gK,8,4,0,0,12
R_R8Puwc6rHfK6pcl,6,1,0,0,7
R_1IdbguukxWD7osK,5,5,0,0,10
R_2aUBMpuxcqLCkhw,6,4,0,0,10
R_1eRx757doyI359h,1,3,2,0,6
R_2WMZbqyIo5BkTRu,5,5,0,0,10
R_1gI8qg2WdXjYraa,5,2,0,0,7
R_2QSBSWQZhloIRVn,7,2,1,0,10
R_2TFgn0P9Y1x6T1j,9,1,0,0,10
R_12kYUO2xizy98Ho,3,3,0,0,6
R_2fldv49qCr71shJ,5,1,4,0,10
R_a5GeAXTcsoHMxQB,6,0,0,0,6
R_3W8QZcMYGayxlnP,3,5,0,0,8
R_b4rR3dPZRsIrE2J,7,1,0,0,8
R_2YY31uJ84x4P1Sv,5,0,0,0,5
R_3MLNLLllGci7VqD,6,2,0,0,8
R_2R9rJwvwbWiKsER,4,3,2,0,9
R_3OjYUM63jOs2lWz,6,3,0,0,9
R_2UaC8vlEJikP9si,9,1,0,0,10
R_6yuNJHPZLufuYcp,5,3,0,0,8
R_2xFQa3xBPxV60RU,3,8,0,0,11
R_2ZDpwoww70QAi1v,7,2,1,0,10
R_2PtDsBFhZM2K7J3,6,2,0,0,8
R_2cbgAW4kSg23mAD,3,6,1,0,10
R_XhOHltnP55JBH8d,9,3,0,0,12
R_6RkLJvbFU0TLJu1,1,2,0,1,4
R_1zsLgjKRZs15gNH,7,2,0,0,9
R_1dcpAwNHoUPNWaq,0,6,4,0,10
R_2rGcamXcfYghCDT,3,5,1,0,9
R_2z8CkbzAYtetNuS,2,6,1,0,9
R_27qvyyxKSsuFo8p,3,2,0,0,5
R_3qCZodyDmMUou83,3,4,2,0,9
R_20TlyOzsrkB4zfp,5,2,2,0,9
R_1davrCZ30k7uYsb,8,3,0,0,11
R_5u1p78AORPAby4F,0,4,3,0,7
R_10pBhNxGDmamMzG,8,2,0,0,10
R_3EaiqtR9lPxKp2h,4,4,0,0,8
R_1MXm0CqkpfiTqnT,5,3,2,0,10
R_3gL2fTkBFBiCmVT,5,4,0,0,9
R_TdRJ9GAvaSOlYUV,9,1,0,0,10
R_2DS9eO7xdhk0ip5,4,6,0,0,10
R_2xKwzUHnyZPD9GM,7,2,0,0,9
R_1lboOJv9CtYneb2,8,0,1,0,9
R_30oev1p7mo6Al6q,9,0,0,0,9
R_5psbaqoxjDrHKBb,5,1,2,0,8
R_3kG4dVUfu6TWxsw,5,5,0,0,10
R_1hLRf8O9GJdHqzC,6,3,0,0,9
R_UL503Bb33HieLlf,6,0,0,0,6
R_rrp5tVIJlNzNnQR,7,0,0,0,7
R_2dWkxtnSnUl7zGm,6,0,0,0,6
R_1gTPncKTgF9G5S0,4,3,2,0,9
R_3GvToqY9bsPbaMS,5,4,0,0,9
R_1Qz2fzaaWP0D2rk,3,5,1,0,9
R_2UhYJaulsR06X56,7,1,2,0,10
R_2di0TFrVf0lllJ0,8,2,0,0,10
R_1IEK37m1IKBeSZ5,8,3,0,0,11
R_3qrmoWhqxksoKOH,7,3,1,0,11
R_1JXVr1mzG0n2Scz,6,4,0,0,10
R_2YgpbdIZ5HEqZzN,8,1,0,0,9
R_3p9WfnHpuhrikwa,0,7,3,0,10
R_2xXYraGDd2zQvDs,4,5,0,0,9
R_1ojOAK6yk0bkjl3,5,5,0,0,10
R_2sak2bb2DE2dbju,6,2,0,0,8
R_3PYoEICKpqCvrNK,5,3,3,0,11
R_22mOjfb9jaclzPs,5,1,0,0,6
R_yIy2gVz7FdtIFpL,5,1,1,0,7
R_Q4aahuWCrOj6ye5,7,3,0,0,10
R_3q9aMERagysCsL0,2,6,1,0,9
R_3En8JqYOApYSpx2,6,4,0,0,10
R_1dzEfNtBt1bMlBh,3,7,0,0,10
R_1CEF1OXwVGThnzP,6,5,0,0,11
R_1dHcE8UX8ICZBpW,7,2,0,0,9
R_R9a3Cjuw7XBnYat,0,7,2,0,9
R_DObf0gv7HZ5uuoF,3,4,2,0,9
R_2YtZDVE5uG2vqsj,0,2,6,0,8
R_3RjykR5xn1eK34r,10,0,0,0,10
R_BE7EXTABwgnzFoB,5,3,1,0,9
R_PFA4VktadwN6NiN,3,5,0,0,8
R_2f0RMmGezCDUkVP,3,3,0,0,6
R_2XifoIbfBj54KXt,4,1,2,0,7
R_3J8HxHUNs2etnKo,4,5,0,0,9
R_10Hj1q7Kf2NMrpc,7,1,0,0,8
R_5gQDI99ENasAo5X,6,5,0,0,11
R_2SwANEncL2nkrLB,4,2,1,0,7
R_PUIe2JURLNpCoPT,5,2,2,0,9
R_wSkQ90MG4n7SGNb,5,2,0,0,7
R_1qe8manIdKxjXaJ,7,3,0,0,10
R_2ataYck0GWy9l5S,8,0,0,0,8
R_Y3sq2sRJArHnUPv,6,2,1,0,9
R_2ymijyA4dAMQwKs,1,7,1,0,9
R_1eXz5o5Nuuw5Zjp,7,3,0,0,10
R_31ED1C4RrPYeu3z,4,6,0,0,10
R_2t3ZRaJJz1bwFFf,8,1,0,0,9
R_1o5PJEiNGtE5vdH,6,2,0,0,8
R_1cUfYmPWlkQJ41Y,1,0,6,0,7
R_1KkAxQBs7E4HMpf,7,1,0,0,8
R_6F0w5thI8PtTwGd,5,1,3,0,9
R_30ctqwNS2wdTQ5p,5,2,3,0,10
R_1q3N4JFQm18kq66,7,0,0,0,7
R_1jPvqBYxlDlcDGM,3,6,0,0,9
R_QhbXKbMMLtfgdI5,9,0,0,0,9
R_0BzwEBC28sBvLbP,7,0,0,0,7
R_27kxYEYop4MHhRR,5,4,0,0,9
R_0PQwqywBQxsXnMJ,1,1,6,0,8
R_2tD4vppXuhDu1KL,6,3,0,0,9
R_eal5fD6JA5VHBMB,6,3,0,0,9
R_eKwRS770C24BYtz,6,3,0,0,9
R_3HNgQXt8WvUauZB,6,3,0,0,9
R_2OUU7lTr3b0Mb6P,6,4,0,0,10
R_XiIXTJ4C4lZVStH,1,3,5,0,9
R_2YWHvE0cHCk7Xq3,4,1,3,0,8
R_20YwcaxqHHP99tb,3,1,1,0,5
R_217K5TXFU26bpcH,5,5,0,0,10
R_5o5runWzmQClV9D,2,7,1,0,10
R_2rBAOa4u3pZxVXO,6,1,1,0,8
R_1ibdCG5uwChekPc,7,2,0,0,9
R_xyFxI7QFof23kmB,6,2,0,0,8
R_D7QubxTHLYvhRPr,7,4,1,0,12
R_5iI8lYsmXNns493,5,5,0,0,10
R_1cSyUrjNWEXF9yx,6,1,0,0,7
R_1eK3iMommHkXz1Y,6,1,3,0,10
R_vPmmPKMAygEldN7,3,5,0,0,8
R_24AxtFrKtmm7YOI,5,6,1,0,12
R_2Wvd6roDna9xtTT,3,3,3,0,9
R_2EtNBc7J9PZiAvK,3,4,2,0,9
R_BSnFd1AWXdsnFjb,9,0,0,0,9
R_1DSB9Yia8Vqiprr,7,2,1,0,10
R_2Csk5Ju3F3ey5j2,8,2,0,0,10
R_3oGhwZeHXSU9BAm,3,3,2,0,8
R_29h3JvCOdSAIpxL,9,1,1,0,11
R_31ucpxCv4a225cF,4,4,0,0,8
R_2rolKaEJfsf1kEE,8,1,0,0,9
R_1hDPDst9CwZLPHg,5,4,3,0,12
R_udN97tQr0yDdcJj,5,3,0,0,8
R_22kWuu153GCJswY,3,2,6,0,11
R_rckSj7trfv1dJzX,8,2,1,0,11
R_3fwX1uPiopEgVSW,5,2,3,0,10
R_3HjEYjhAh2BkNB3,2,4,2,0,8
R_3LgPoxJEnzS0ubn,8,0,1,0,9
R_1P6ss4C7sC7Yidq,6,1,0,0,7
R_1mOVBis6M5JRp3O,4,3,1,0,8
R_1pYe5MoR1ATVG8C,7,0,0,0,7
R_2rPhJPl6hdjDbPt,4,4,0,0,8
R_8iBFnd4s9nLta7L,5,1,2,0,8
R_3fU9MpNDxwExYdD,7,5,1,0,13
R_BwSKZnFoaSAc92N,5,3,2,0,10
R_bC3YF60MXBXhPGN,2,1,6,0,9
R_2TMlaKe3CfaTGud,0,5,6,0,11
R_22GkfLzInl9K8v7,7,3,0,0,10
R_3r070EOrReIOIe8,4,8,0,0,12
R_1obXc7e4P4sqoIZ,6,3,0,0,9
R_DBHRjLppapRq6Nr,5,3,0,0,8
R_3pgbFkWUeemve5x,1,7,2,0,10
R_AbapfeqpOilw5Cp,6,5,0,0,11
R_12QsiTFS2IkqQXJ,4,4,1,0,9
R_daKi8M0DFU5Uxrj,8,0,2,0,10
R_abAdfMZBIEhVEkN,9,0,0,0,9
R_UgTtiRNgE86B6h3,0,2,5,0,7
R_bdrCcKdp4OYNV0l,7,1,0,0,8
R_2wRWlsARexSEyWY,4,3,2,0,9
R_1Cvxh9d6mPRLVkR,7,0,1,0,8
R_1msBCCRU1dlC7GP,8,2,0,0,10
R_2tmR1qfmlZcv5Ew,6,2,0,0,8
R_2QmpdDzp1Ijd3EZ,6,2,2,0,10
R_3HoCr2F30sHil0q,4,3,0,0,7
R_28Ve4STSmlKBFhj,4,5,1,0,10
R_3oAxSSOKs2UCU9t,5,6,1,0,12
R_3eyrTFBwjlDwhyP,5,4,0,0,9
R_1exEUycEVFmX5tL,4,2,3,0,9
R_3EhDKppm42LP9Rp,8,4,0,0,12
R_4ZqeI2rHIsKI9Z7,7,0,0,0,7
R_1Hod8JssUx9WQ11,6,3,0,0,9
R_1LhCdjjWt3pT1hM,3,5,0,0,8
R_28Uq5bDs6XKX5Xg,2,5,2,0,9
R_1hSWC3XMPb8IpW9,0,1,5,0,6
R_UQ2NhlHiMaWzOdX,4,2,1,0,7
R_xzV2K2vs1DQzmaB,8,1,0,1,10
R_xufF5k2fRwjb9Ml,2,4,3,0,9
R_3lDK8cAt0uc7b9C,2,6,1,0,9
R_3fIZtLR3teqLEfI,5,5,1,0,11
R_R3olgXJyFaJcI9z,2,4,2,0,8
R_1ibcrRRZxsnTrV9,7,1,1,0,9
R_1IXaMZ8CUO9A9hI,4,3,0,0,7
R_3mn7XcWALQEP3fr,7,2,0,0,9
R_10It6mbDHudasCA,5,1,2,0,8
R_2eQdKz6zYddLDIq,5,2,0,0,7
R_1JLXlgcaIKuqnMF,2,5,0,0,7
R_yOty2Ku2NjTrkUp,6,2,1,0,9
R_2zZRsqhOoJjLhyv,7,2,0,0,9
R_ST2OcZZA2uNIbMR,4,3,1,0,8
R_3r0LEPZhzkG3zJu,4,1,0,0,5
R_27ewvolTmpjrt8a,6,4,0,0,10
R_w5lrAUW6KnPC9Ut,5,3,2,0,10
R_dal9ZMPRHVoSugF,7,2,1,0,10
R_3JsDKAuYR0aKLyK,9,4,0,0,13
R_1LCf1k2wD4drdkg,4,5,0,0,9
R_w74OGHcUiKfZDgJ,3,6,1,0,10
R_2e9ks6bRiSemvzv,4,3,0,0,7
R_33kSPDBGYIZkH0p,4,1,4,0,9
R_1ZWEsxeXCnYESVH,2,9,2,0,13
R_27EAKrpkdsLS9FF,5,3,1,0,9
R_yjRFpS2eVjm8tkB,6,4,3,0,13
R_tFNaqYS4RFKlK1z,1,4,4,0,9
R_31vALlcubxxiOT1,1,3,5,0,9
R_1rpNfBbjiItJGx8,6,3,0,0,9
R_2EcsXB9O3sG6L4x,9,1,0,0,10
R_3Kr7Pzupi2T2rX2,4,6,0,0,10
R_5iiA3Z0PdwhhM1H,3,6,0,0,9
R_324NCblveMECxvU,6,2,1,0,9
R_339mRtIAkEbegcS,6,1,2,0,9
R_DdisothZpF30VrP,4,5,0,0,9
R_3ql0BjDanbhjwRu,4,4,0,0,8
R_1LnF5iyYOWOvMC8,6,2,0,0,8
R_1LOiWgemsZkF2dw,1,3,3,0,7
R_1GZ8G3B4LUo7lqU,8,2,0,0,10
R_qzskHBXlauFZNMB,9,0,0,0,9
R_2wNVKT6Pl4jW1Gg,5,5,0,0,10
R_2uVCHMgIqOEQx02,3,5,0,0,8
R_1esn81KSwhj9bSi,1,3,3,0,7
R_XsQUlPy6WV7vfqh,2,1,8,0,11
R_1NFg35Hn6Z0WzvW,8,1,0,0,9
R_30uu8eNCo8cexaJ,3,4,1,0,8
R_3NESATDlT4EVhWN,5,4,2,0,11
R_1Ii23OlpreLLKmL,4,2,2,0,8
R_1FzfwHoVHDoI0ct,1,4,1,0,6
R_3CI19hYoGwhSFoW,8,2,0,0,10
R_2VmzSbkdrtNaILs,7,1,0,0,8
R_8D2pzENMnisE3qp,4,2,1,0,7
R_2dPSWtWk34IUWq1,4,2,1,0,7
R_3lPn0oVcAUKdl6J,4,4,1,0,9
R_1CJGUncsC3tcZVz,10,0,0,0,10
R_2yqjrBwiyJRNHva,6,3,1,0,10
R_2qxWanrEn0bfJo1,6,1,1,0,8
R_2wA09ReyekLf1FI,5,2,2,0,9
R_3gXIP5pfOOYaPgt,5,4,1,0,10
R_3PTubAWGUw58pqo,9,0,0,0,9
R_VJg3fzTtyg8obHr,5,2,0,0,7
R_2sdJleb5sZJQqys,6,2,0,0,8
R_2dgSBbi9mjgVw4R,2,5,1,0,8
R_1kHUhjUQe3lBbht,4,3,2,0,9
R_1H0iGrpP1iefBSL,5,1,0,0,6
R_3t10M8vdDw0LNIZ,6,4,0,0,10
R_2riJFwWA141rK4E,7,4,0,0,11
R_3OiDtmIcqixxQTI,9,1,0,0,10
R_1kUOsyqQOlSijUP,5,2,1,0,8
R_A6FJfnhhqXU9Ufn,4,4,0,0,8
R_2dQOcRhQfT3af5h,4,3,0,0,7
R_2rkWNnETMYuj3l3,3,5,0,0,8
R_1OUIhovEX6umxkH,4,1,0,0,5
R_31jbieGANWy9TTR,5,5,0,0,10
R_XnYSMDGzsCtbecp,5,4,1,0,10
R_2wpOMm2N34YFQIV,5,2,2,0,9
R_VX5AvMFur5JP6x3,5,4,1,0,10
R_3G9XMWbvVQ8O90p,4,2,1,0,7
R_yr5sAngLMS1XBER,7,1,0,0,8
R_e4ZTTtWwkXkEeQ1,5,3,0,0,8
R_1cZCBaLUpifSbMe,6,5,0,0,11
R_1NabIFXjpSjYAqf,7,5,0,0,12
R_xgROXquLG8l9q8h,4,3,0,0,7
R_3pcfY2cwpzNOECo,6,4,0,0,10
R_1Fmicto7SHbOEVS,2,5,1,0,8
R_4OAiXx4Iy4EZarD,5,4,0,0,9
R_3Pcs75kkDNMRfoD,8,2,0,0,10
R_1OxBud0fpI0DUqM,2,6,3,0,11
R_1mIY047hqcfk2co,8,2,0,0,10
R_279eswVBIxPPc1M,6,3,0,0,9
R_9vRxjmPkzxHZpf3,6,0,0,0,6
R_rfgsHkIcoYbkcff,4,3,0,0,7
R_a93MdBAMgQbs6Jz,7,1,1,0,9
R_Wr3fnQilqteuZOh,8,3,0,0,11
R_4JaORQXtonAGz1n,6,5,0,0,11
R_2tK9xr4wC56euF5,3,1,5,0,9
R_3O8hyNTneZlaIpd,2,5,1,0,8
R_7Pu35VeG4QZH0Ln,1,8,2,0,11
R_3RjCKs9QmIfo2XJ,1,6,3,0,10
R_1IJYNLwBKpzCugA,5,5,1,0,11
R_1giIlrt7YZCumzW,4,2,0,0,6
R_1M3V3XwPy3QGCia,7,2,0,0,9
R_2V7toZRw5Jm2MEl,4,1,2,0,7
R_2E6NG6jTGDDmNC8,9,1,0,0,10
R_3PgWd1oeDzZPemE,4,4,2,0,10
R_ctECQ0gu7FiwnCx,5,3,0,0,8
R_1HhN7k76vbSChFe,4,3,0,0,7
R_Cf5Qp3qR1Jw1Rv3,4,1,4,0,9
R_3GeOT8nNvKRBSVT,4,3,0,0,7
R_2zT8bP83zXTKc3v,9,1,0,0,10
R_1JF77LMXNWO7IHR,2,5,1,0,8
R_2BrOrkofKSX5eYL,5,0,0,0,5
R_1gkgPeiPPZKHeyI,3,1,3,0,7
R_1Gw3OP5WnHt69hX,2,2,4,0,8
R_a053z8yDW39v0dj,3,3,3,0,9
R_3LZ7iIYOOsgNge6,2,6,2,0,10
R_vUkqjuG6p2EcU1P,3,6,0,0,9
R_3GCDQf7CJ8RmyVC,3,2,0,0,5
R_3MG1bXtRbF2rY7g,5,4,0,0,9
R_eaII1C2sPZtq4OB,6,2,1,0,9
R_1AYex0NjicTiMhP,7,0,0,0,7
R_1luEGUt49sfXlK4,5,5,0,0,10
R_2wERBeyZWKRrepk,7,3,0,0,10
R_2B3RUEvkU8GaAlZ,7,3,0,0,10
R_vCZVhJwWUc14IGB,3,1,0,0,4
R_2AXaaj1k6ba6OjV,0,1,4,0,5
R_1QhdBnAYV1e0tk0,4,4,2,0,10
R_3qXcqE65lVgT5Dn,2,5,1,0,8
R_3EbtVZnj44TSZ8Y,7,2,0,0,9
R_2yqOVrRdbabnb3Y,7,2,1,0,10
R_3qxs8DF5zRWPVc1,5,2,2,0,9
R_3Kpv9UHWbYMDq8l,4,5,0,0,9
R_4Zbp5igXscd6Ilb,5,6,0,0,11
R_3qCGqyFSN3fYFLs,1,2,2,0,5
R_1jJllBhOPqsls5u,3,6,0,0,9
R_3e9urUQGaO12gO2,6,3,0,0,9
R_1pKI9hZNemDXTUg,4,3,1,0,8
R_2y7MvYceUtcWskD,4,5,1,0,10
R_Z8XsvtUmWgJxLH3,6,4,0,0,10
R_27lMXC0mD8vWYoE,7,0,0,0,7
R_xttyrVXkgUHvNoB,4,5,0,0,9
R_3r1WZwnFhVzFJ4w,7,0,0,0,7
R_e8lRGZoQ8QGcXAd,1,5,3,0,9
R_2xQ6NhGZI4HFl1o,4,1,3,0,8
R_1IEI9SSgwAoQmCK,6,2,0,1,9
R_vdY8LIJFRsHitHP,6,2,1,0,9
R_vJhuT6afHg2feGB,5,5,0,0,10
R_1duHbXTiydE5Bbf,6,4,0,0,10
R_1mXCHh4rAvOtpWc,5,1,0,0,6
R_21mnDSJSzz8DgST,8,2,0,0,10
R_30dWBFNawHSAPn5,6,3,1,0,10
R_31BeAfYKSjg5u3O,8,1,1,0,10
R_2S32SfGPqwRUYal,3,1,5,0,9
R_1jeKPtOdACYjn8E,7,2,0,0,9
R_3D2en2JVVK7rnDf,6,3,0,0,9
R_3mkOy7k48fsIkxa,1,7,2,0,10
R_2U41JdwOD4vMJZh,7,4,0,0,11
R_3HvqZfNT1p5ei1R,5,4,0,0,9
R_3qeyIZyErx6o0yG,6,3,1,0,10
R_3Kxxe5KKotnYANM,2,3,3,0,8
R_3NxGnXx1j5OJ1D2,5,5,0,0,10
R_2y89hKToL4OVn11,4,4,3,0,11
R_2zOc1jQVvWlQOMr,8,1,0,0,9
R_SN2bFWxBTAzbJpn,4,4,0,0,8
R_25vhZY2oDhcUw4H,6,3,0,0,9
R_OvT5plxf5rrgJ8Z,8,0,0,0,8
R_DpgJRB56HOK0IP7,6,5,0,0,11
R_3FJ8Pi1qE7GsGdG,7,3,0,0,10
R_1IyBviiXRROVDae,8,2,0,0,10
R_1LUuje4ITytB5o6,1,3,3,0,7
R_2pRZxqYOZKv0Qbn,4,4,0,0,8
R_1jpR4tsFiNaZhiA,6,4,0,0,10
R_3sBNGSF7Onka7zG,8,1,0,0,9
R_2TUkZeQ0XtmUhKj,7,3,0,0,10
R_1Lv9552coFU8lyM,3,5,0,0,8
R_3DoP97GEC9DT4MV,3,5,2,0,10
R_p5eEV8g7mmQb8Sl,9,1,0,0,10
R_2c7aVZM7pVwsnIB,7,0,0,0,7
R_1gjd8VIYqsbRLpD,6,2,0,0,8
R_VJZemIjCK9wZ23T,9,0,1,0,10
R_viXrYdTVnV3seMF,9,3,0,0,12
R_3fkgLqrzmEzLhrV,8,2,0,0,10
R_1rD0vcIGXivBzfw,4,4,0,0,8
R_1Cwtt5sl09kdDi3,5,3,0,0,8
R_0JL1EyqHKBuhqq5,5,3,0,0,8
R_2TESoWnMtG2oClB,8,1,0,0,9
R_RPipWh4tAXMXeZH,9,0,0,0,9
R_1JFN0W5X3XUSSmt,5,0,0,0,5
R_5nhICeqMHKpViyB,4,6,0,0,10
R_2cCIzM73qrlMwHj,7,1,0,0,8
R_sby15Z1aVKIY04p,6,4,0,0,10
R_1pM8x9gKvJjDzAp,6,2,0,0,8
R_2cbIdC6ffPgWBIx,8,2,0,0,10
R_1ooMC8E3UZCAECu,5,6,0,0,11
R_3G3xd14LdSI30em,6,3,0,0,9
R_PBy9eCzfZtt4IJb,2,3,4,0,9
R_ZqL5jRD49iuovbH,4,2,2,0,8
R_2aJODIFV3JPn6rm,5,4,0,0,9
R_1MVSrFQXVPoQbd4,6,2,0,0,8
R_2tEbvsXcbIgphr6,5,5,1,0,11
R_DNNrLyDWintmWIx,4,4,0,0,8
R_2y8Es5JAUwOecxj,5,3,1,0,9
R_DTb9sbHZcP4ZRO9,6,0,2,0,8
R_3Gd1P3ouispxutR,2,5,3,0,10
R_12bwHAIYewiDeTf,2,5,0,0,7
R_2WJxPu4kJiq8Fcu,4,0,3,0,7
R_3iQMbMeV6TkjvZV,0,7,1,0,8
R_2Cp2C8dLv8OSg94,7,2,0,0,9
R_UFkoLXtNDcmlpHH,4,5,0,0,9
R_3fVO5mopMigg0z9,5,3,1,0,9
R_2cBMhblSNxdZEAd,2,6,1,0,9
R_1mfpouJo1JYVUBU,5,1,0,0,6
R_Q0m9mjbqlM7EtHz,6,2,2,0,10
R_1M5Lmg3SM0g1hgf,7,2,0,0,9
R_2cdXRq3XCGmm7KE,2,6,1,0,9
R_TcnuVX8Lz8IeISt,9,1,0,0,10
R_D2FF77bljbhDv0Z,3,3,3,0,9
R_1kTfd1uxowI35s6,6,4,0,0,10
R_ANwpzhRYGKr4bgl,4,6,0,0,10
R_6VRJoAcTjyJsDg5,6,1,0,0,7
R_ctG74GnV7dqlXNf,6,0,0,1,7
R_qW8oBXhXeKqXViF,7,1,0,0,8
R_27kd7wCYapruPrf,5,1,0,0,6
R_3sysuZSE8xn5YdC,5,2,0,0,7
R_2YVMxW0ni8Ze4ss,5,4,0,0,9
R_em5tCM40xRws8U1,3,5,2,0,10
R_qzjh56IG5y6HyEN,10,0,0,0,10
R_1Q6qc5bCv40uDRT,4,5,2,0,11
R_82gdr1pnm3YvHXj,9,4,0,0,13
R_3QRIgEIRuENlzHv,6,5,0,0,11
R_DIQjX4Qt2AZYes1,7,3,0,0,10
R_2ZOA0nr5D5DqdgN,1,3,3,0,7
R_1CHMkQdRKK4uALs,3,4,1,0,8
R_1rpGWqbPX334BJY,7,2,0,0,9
R_24l31vGECh2VKdO,6,2,2,0,10
R_3DjUTMNOG0r7scx,5,2,3,0,10
R_u38frUbFtHOriHn,7,3,0,0,10
R_3lPpGn3wLXp6TaP,3,6,1,0,10
R_2VJ7W2sd3icFYlV,6,3,0,0,9
R_3EzJ3kPMtcA70Hh,5,0,3,0,8
R_1r9rbKeNr0KMU7y,2,3,4,0,9
R_WjjNSmJBCMwgIOB,5,4,2,0,11
R_2WYxcW2NcD5nvYV,6,4,0,0,10
R_2eP7ePtLW46H9sX,6,4,0,0,10
R_Zr5kxaU2ZWezAxr,7,1,0,0,8
R_3OrfEr3JfEmfdxH,5,3,0,0,8
R_2e5ty8jR375WBy7,3,2,0,0,5
R_2c75fjrRTU5EpRc,1,6,2,0,9
R_1ri7tQOeY8T1Soz,11,1,1,0,13
R_2qjDIIUr4HCDoNN,5,5,0,0,10
R_1eWSxexshTAb8iJ,5,3,1,0,9
R_wXfynz3J7u6MEil,8,1,0,0,9
R_2EmdFSmoOU6oKmw,5,3,1,0,9
R_xfqhzuz3T0hXc3f,7,2,0,0,9
R_2Vg2GLjvaXlufZ8,5,1,0,0,6
R_3EGYdYNTzUHGaf7,6,4,0,0,10
R_yJTVdolcjRPifmx,3,3,0,0,6
R_UZ6P4j5s6aUBBpT,7,2,0,0,9
R_1r1dfJsiTZBB1lb,1,8,0,0,9
R_3gZsMDWWzrgNmTA,6,4,0,0,10
R_2ccsYDPik5IBK7Y,3,5,0,0,8
R_r8DbvIX4TLDmz9n,3,1,3,0,7
R_smTc1WVB2XA5KkF,5,4,0,0,9
R_pinRnKppH5iygLv,4,2,0,0,6
R_2e9gMqRRl0ieGq9,3,2,3,0,8
R_2rvIdN8iUWOZqzM,5,3,0,0,8
R_3RqIGs5UHMsag1h,2,5,2,0,9
R_2P5qMIlnp1M6C2H,6,3,0,0,9
R_1CJVUnUq6TEf9lE,9,1,0,0,10
R_2wESBluGp2k64Uf,4,2,2,0,8
R_1gupTg7A6GD2EdU,8,1,0,0,9
R_3KCLH3lTRYMrVg7,6,6,0,0,12
R_UbTTQR1R80v25cl,7,1,0,0,8
R_31SGF6ntO4MdRgR,5,8,0,0,13
R_1rBJGXDQc98eT4s,8,1,0,0,9
R_1jPM3Pzvf9HIqAD,7,2,0,0,9
R_1DIpM1DlPtqHJca,6,0,0,0,6
R_1QtmR67EjxTxI4V,8,2,0,0,10
R_8tXqW6LFQL8TUWt,5,6,1,0,12
R_31B4bvL2rOD5NLI,5,3,0,0,8
R_2aLwXRstKsXdMAJ,7,1,0,0,8
R_qOuwjKzJ9ONL59n,6,2,0,0,8
R_1nNhAdXVyrHb73r,4,5,1,0,10
R_aWApZIKoJcnKRsl,5,1,1,0,7
R_26nFk2lcGrhl09q,3,6,1,0,10
R_3fiYelLCDhap2g4,1,3,4,0,8
R_1gi2C1cA6rXNC28,1,4,6,0,11
R_2s0W0tqcxPFpOJL,5,0,1,0,6
R_2zchPZFG9tW92Wv,6,4,0,0,10
R_vCdrUQNQYXHJBVD,3,2,1,0,6
R_bIQ4pfqHUbU7V4J,12,0,0,0,12
R_1l6jWi7SjdZcIfE,4,1,0,0,5
R_2aqSVOc46FqBYZN,5,4,1,0,10
R_1q8QrR4l1Lsxzv0,3,2,1,0,6
R_3fpg846U01vwuLd,7,2,0,0,9
R_qC3orWEAwenBcQx,5,4,0,0,9
R_3hmx3qJOZITQCyx,2,3,3,0,8
R_2Qm7BIX7DMhhbvo,4,1,2,1,8
R_31AW2hSrD1flnOW,7,1,0,0,8
R_21hwpgMiwEz5bvX,2,5,1,0,8
R_vuiVjNC3YxM7nVv,4,5,0,0,9
R_RWhQGFV26kTp7zP,8,2,0,0,10
R_2dL4rsD2AcJcY4F,5,4,0,0,9
R_1HUGf8eaIIBb8sh,6,0,2,0,8
R_24Ns4TWTciLbYSK,5,1,1,0,7
R_2BlC8fJV3pQFy0M,5,3,0,0,8
R_1cUKTqndbg8Isjj,6,4,0,0,10
R_33p7wkWbb8kHpLQ,2,8,0,0,10
R_sYHGkxnlVxKXkTD,3,1,5,0,9
R_2PuPIcE8NUXlBQX,7,3,0,0,10
R_XYzzmG0A31NkfWp,2,1,5,0,8
R_3sjKsBMEfXfXgbr,1,5,5,0,11
R_20NDHjo7LcIfFdU,7,3,0,0,10
R_3PoYT4hzAQO9gvl,6,4,0,0,10
R_PFEuEwY06kg78LD,3,5,2,0,10
R_1KxqTKRtBuWilWl,8,1,0,0,9
R_3rZLI5tX8YaXSie,3,2,7,0,12
R_2YfRdLBqmFHyBiO,6,4,0,0,10
R_2YPLZXsXf5VYDAb,6,5,1,0,12
R_1DuOWCJjyDo0CtC,5,3,1,0,9
R_stcPFrOeH5S4oUx,1,8,4,0,13
R_79cTOSuqQghUqYN,7,3,0,0,10
R_2ClhEdVJZqRuSHx,9,0,0,0,9
R_xDjLkVNrTDE1ntT,6,1,2,0,9
R_3EiNE9wE7GJ3hbd,8,0,0,0,8
R_3g6pOxKxovGflee,10,1,0,0,11
R_3dK9wv1ctPLFXLY,2,4,2,0,8
R_82gJCMAdXILnTj3,6,4,0,0,10
R_2w4PAAvF2UdFwN3,6,5,0,0,11
R_1OZhiNPmEkAXSiD,8,3,0,0,11
R_2wM6YVrxhMa4fgW,1,9,0,0,10
R_eM2bcGPjSZhX6Ip,2,5,0,0,7
R_1rcQYbviXN0e6f7,4,4,0,0,8
R_124N9cGoiA2a8ft,8,1,1,0,10
R_BXSTmNIIEhdsvtv,4,3,0,0,7
R_1JW9FJ3CBocNcRN,9,1,0,0,10
R_3rJ9yjCHS6AD7gw,8,2,0,0,10
R_3PjM0F5O8Uq7RK4,5,3,0,0,8
R_2fK9hUeAJhGLWar,5,2,0,0,7
R_1IHqsEgxCvvGYRo,3,2,2,0,7
R_3rTGAQCKjOkBnjo,4,1,0,0,5
R_1NndLvItiJZByQ3,5,3,1,0,9
R_3fBgCUDJzd1nugR,3,7,2,0,12
R_3sBnk1grofhNThW,7,4,0,0,11
R_xnpg2eGvmYZls5z,4,4,2,0,10
R_3ku24zEoLqVquD1,3,8,0,0,11
R_3Ms6Nsat7lR8oIw,8,1,0,0,9
R_3PN2trxVV8F29Hi,8,2,0,0,10
R_sEY5NoY2ERL11BL,6,1,1,0,8
R_rpCSO1ZKe63lG25,3,4,3,0,10
R_3nMzscFoTmwDkYU,2,4,3,0,9
R_1KedAjRCwrLAR5k,6,2,2,0,10
R_2sRSxghz8AHTbqS,6,4,0,0,10
R_1DZFA9tZdMc62pM,7,3,0,0,10
R_bjiehIoYnzqAOnT,7,4,0,0,11
R_1CwmlKlThNZ5nxK,1,4,1,0,6
R_VXphKjx3s5kzBMR,6,2,1,0,9
R_31ZMQiL341mEOsz,7,1,0,0,8
R_2S2i3lg4cHUKPIv,4,3,1,0,8
R_3pcl5qdogOuUigi,7,3,0,0,10
R_3MSsQ5FgnWJbsis,10,0,0,0,10
R_3MmKKIseNgAJKFP,6,3,0,0,9
R_1r0pVpq6KRA5c0A,3,2,2,0,7
R_C3UFv8cjxZRBILn,8,1,0,0,9
R_2905AA0HV398raL,1,6,2,0,9
R_300h64wDLNroPkI,3,4,2,0,9
R_2B5I8oGyUUAu6CI,4,0,0,0,4
R_1jVXgPMpMuMmpIn,4,5,1,0,10
R_24C8zaXFGd4juCs,6,4,0,0,10
R_a5nh9rTbD89IJlT,8,2,0,0,10
R_3MMWegcwg02zeU0,8,4,0,0,12
R_uerV5VbeA3b8loZ,4,3,2,0,9
R_3mlxNkkRTtpJuKO,7,2,0,0,9
R_cBGFfJ25kRGrnPj,6,2,0,0,8
R_25SE1LtdYqTVvwv,6,1,0,0,7
R_25XFcZMtHj57EaL,4,3,2,0,9
R_31QuoXkEGO3mHGU,5,5,0,0,10
R_31aet3381kOJev9,4,1,3,0,8
R_1P6R6RypqGTsjNZ,3,3,4,0,10
R_W6Qv2TpDajBAVfr,5,5,0,0,10
R_3pgydyEVhNNAzHF,0,4,1,0,5
R_QcQIb4txpkY0bu1,4,3,3,0,10
R_9LENqMAyowjce1H,5,4,2,0,11
R_2S9si7yy5tNulba,6,2,0,0,8
R_Z2xpzm1pqQYWnYt,7,2,1,0,10
R_bwlSJPqGryxLf0t,5,5,2,0,12
R_32R48SsiDkoI0w2,7,2,1,0,10
R_3gZAoeRudiEHV51,7,3,0,0,10
R_d5nR12ueVdCZ9pD,4,4,2,0,10
R_2qpC0WXbnIp0h2r,7,2,0,0,9
R_2PpYujGZn5Cn59s,4,2,2,0,8
R_2uF1Zj3Bq9awpbg,6,4,1,0,11
R_24B0SCQ6YPTKx5H,5,1,3,0,9
R_1l9Ua84hb3RoOUg,8,8,0,0,16
R_2w0rhzfEfegBwmA,3,6,0,0,9
R_DDmtHs2eKSpunjr,3,2,3,0,8
R_3pnKhPFw61VlM6q,7,4,0,0,11
R_3F2SyXeofm6pc3R,7,0,0,0,7
R_RaCkFLjPYp6G5Rn,3,2,5,0,10
R_1jqbEjynQc4nnGz,5,4,1,0,10
R_RfNnmPpcJ7JqRSF,4,2,4,0,10
R_1rCI6zLgDatqAjS,7,3,0,0,10
R_9G42XRMMEIw7CiR,5,5,1,0,11
R_3LXQYQUY2b9zKIP,1,3,4,0,8
R_3KxZS4LlX3vuVCP,8,3,1,0,12
R_2SftNhBkcWwzIk3,2,6,0,0,8
R_21oFJBC2aLLd8Qx,2,5,1,0,8
R_1FzffKmMsTJnmnW,2,3,0,0,5
R_1M3BRw67Ts7vPbh,9,1,0,0,10
R_3DitjkZcHreJMwB,2,7,2,0,11
R_3foUhc6HLbnFA5z,7,4,1,0,12
R_263FtMSR4LCA3S1,7,1,1,0,9
R_1C4v1Pg6WV628Ge,4,4,3,0,11
R_26hHPJV2A2t6Pf2,5,5,2,0,12
R_Wcbsu1l6zWbEwcp,7,2,1,0,10
R_3po6NdD6LCIo7wS,8,1,0,1,10
R_sw1l5sKPR25A8M1,4,1,2,0,7
R_12yh4qfoQkDIGHK,4,6,0,0,10
R_3qxt7FwgY2Lux53,4,6,0,0,10
R_1lzRfvXhzxnJ10w,5,3,0,0,8
R_4NHL5FEsXJLwn05,5,4,0,0,9
R_1LShxGd8taWBbca,0,3,9,0,12
R_UisXOKsRILbTUB3,8,6,0,0,14
R_8dWuNkR1AFKkavD,2,8,0,0,10
R_30oF2MB7OfxFhVw,6,6,0,0,12
R_TdbVy1C2sMNDqKd,7,2,0,0,9
R_2zTGZdD1w9O5Umz,7,2,0,0,9
R_1feKvLjvE93oB0W,0,0,4,0,4
R_3CUcTNwZifNumP7,9,1,0,0,10
R_zdnGTKQSDQczQbf,6,3,0,0,9
R_1LpoLECRa2uahJR,9,1,0,0,10
R_1NrdAKz1PplfGpq,6,4,0,0,10
R_3kFnjfUj2dHpG6h,7,4,0,0,11
R_3LbUif89i57oORG,3,7,0,0,10
R_1FwUZkpPl73Kx2n,5,2,0,0,7
R_BXuEuxFgk8dsdGx,7,2,1,0,10
R_erjeTlqRR8RF06R,6,6,0,0,12
R_3q89Rlv8SpnOOPf,6,1,0,0,7
R_72K14RONhzCXy49,9,3,0,0,12
R_21zFFu8aUGuBnkQ,2,5,5,0,12
R_SNcajhzNNIxLmCd,6,5,0,0,11
R_2e9fuKsqTrpJn24,3,2,3,0,8
R_ronFiTZ1BB519IZ,5,4,0,0,9
R_3I5lBTQGRu2aKox,2,6,0,0,8
R_RhoCy9h6I5CshSV,5,1,0,0,6
R_2rV05RysNAQVu9I,4,4,1,0,9
R_2P22g9J3gti2PS0,7,2,0,0,9
R_p0PbLayQUYKB5FT,3,1,0,0,4
R_2Yz99P8QK2xdcfm,2,5,1,0,8
R_DUYpWAOfnhsRtw5,6,2,0,0,8
R_1ieQT4SnDPm4rFI,7,5,0,0,12
R_Apw2JoYG6wyUf9D,8,2,0,0,10
R_3gYmyK7WJhMoct0,3,5,2,0,10
R_1hYHRmn6d0T9wgo,4,3,1,0,8
R_2wyTgEgLSr1E47X,8,2,0,0,10
R_33yBeFH5UschBAi,2,3,2,0,7
R_BXsHwZ4lCGQDrhv,6,4,0,0,10
R_11WQRNHl4janhu6,7,3,0,0,10
R_1IiybpK5WplyqER,7,1,0,0,8
R_22EyFtJ46jHxjPn,6,4,0,0,10
R_2TRBts9RHnCbq4g,7,2,1,0,10
R_0uOmL6EdSKbyKbL,5,5,0,0,10
R_UFsDXwPArrXmhfH,5,4,0,0,9
R_cMYgWuB5hicVv21,6,2,0,0,8
R_1DCiFVYGt20BWCd,8,2,0,0,10
R_2tKVTBipPPXDkyt,8,1,0,0,9
R_1LCOaTQP5mTJYiF,8,3,0,0,11
R_3GebEqIW71xX89d,7,2,2,0,11
R_pmZNG0w0INZdbgt,5,4,1,0,10
R_2TEIwAOalrSnfvD,2,7,0,0,9
R_3Rmey01pYLUABnS,5,1,0,0,6
R_2VEAw8ciEO4BI5H,3,5,1,0,9
R_2WDv5SbIuLe5IN3,3,5,0,0,8
R_3emp0bw0l2tHLvG,7,3,0,0,10
R_1KxaQLcHBY0eyf7,5,0,0,0,5
R_7OHMLOc1apOiK9r,6,2,1,0,9
R_2bZXLK25pS5633A,9,0,0,0,9
R_2pXeOSCWGs85XJ9,9,1,0,0,10
R_2viYtoJkDruEXW9,3,2,1,0,6
R_3hbe72awTVxzgIu,8,0,0,0,8
R_3EhVvvJtCW5anLw,3,5,0,0,8
R_egjpq0OPaorPMHL,4,6,0,0,10
R_se7HIC0wvMB2xsB,6,3,0,0,9
R_stzagNN9AjYu3Tz,4,3,2,0,9
R_1OqLqlgVMvbEecQ,3,1,0,0,4
R_dmw4ueoUSZtrHc5,5,3,2,0,10
R_DzNKHmLBJOtO8iR,6,2,0,0,8
R_1OTZa2oocYAWLki,2,3,3,0,8
R_3p3lZMgr5BrCtYj,5,0,0,0,5
R_2TTqsi9XMEPgtPs,8,1,0,0,9
R_3kiUFi00zwWI4P3,4,4,0,0,8
R_DJpLtiW2SRywSQ1,3,1,3,0,7
R_3KT3vtSgRMPJHkq,7,2,0,0,9
R_2QzfFKbDaP8aQrO,2,3,5,0,10
R_10V5P04BGyMb0Jm,6,3,0,0,9
R_pfxlQpnyglbrRXr,5,3,0,0,8
R_1f77UMq6UyTzpNQ,5,3,0,0,8
R_3Ej2tsuPNexwKeU,7,0,1,0,8
R_afnOUlf3sQ1yxgd,5,3,0,0,8
R_3egkshSeBEoHIC8,4,7,0,0,11
R_12x959h3WsagJkf,3,3,3,0,9
R_1T8bgudwLabY5cB,3,3,2,0,8
R_1exTJYUwEaLM4NB,5,4,0,0,9
R_p6Q9FDmlfqJNETT,4,5,0,0,9
R_DM2QCMLUjQTNBbb,7,2,0,0,9
R_5AWTS0Z6dHRIqOt,4,5,0,0,9
R_22qW5iU2K5UawII,9,1,0,0,10
R_3LcM3R0Ip0Kkm3t,9,3,0,0,12
R_xc2K18ebM48ditb,1,3,2,0,6
R_3q8UZfIrbabbuin,5,3,1,0,9
R_1hyuPKCgdKKqgfs,6,0,0,0,6
R_bIwMt1zyyLs9RDj,2,5,3,0,10
R_PRJxk0yECZ7TgQ1,5,2,1,0,8
R_2P6visQSD0ZNx6q,1,10,0,0,11
R_2BgkLDcWL9WMUGc,1,8,0,0,9
R_3LjSlVezjwLwxKp,6,3,0,0,9
R_2zNIKgtpcRN4sHu,6,1,0,0,7
R_3Le93sDMWqidUzY,3,3,0,0,6
R_3JXnR7i2nzzZp5L,1,0,6,0,7
R_3Ec0020Ck6pm8qY,5,3,0,0,8
R_71yQlOHRrBXZHup,7,2,1,0,10
R_wY0EU2sxmBWmIXD,3,6,1,0,10
R_3qs9ExMC5IruZrR,2,4,1,0,7
R_1DSkeDTkFRduj44,4,5,2,0,11
R_3HF91jNMEuurfmF,5,2,1,0,8
R_3dDJdXrLaYSJG9T,5,5,1,0,11
R_7ZFF23fNXgH1QQx,5,5,1,0,11
R_3rI1BFY9RBRbqMj,6,3,0,0,9
R_6m37D6rSmxVFhap,5,3,0,0,8
R_2TMHtSMYkotSHCX,3,6,1,0,10
R_1E4HlAnVhxhiK0p,3,7,0,0,10
R_3MaH6zkzI2oowAA,9,1,0,0,10
R_3im0E3dKVQcqBY4,7,3,0,0,10
R_3kdoa3mNxBsWYhB,7,2,2,0,11
R_3CPjVR6S1CuPLJr,7,3,0,0,10
R_1FycUihs6MPjEbY,2,0,3,0,5
R_1jChHNtqmpFZCbP,8,2,0,0,10
R_1gIozMq8r6ijoxY,9,0,0,0,9
R_1mr9TwwWiXde0V6,2,5,3,0,10
R_UgzHSN405Cn7eTL,2,2,5,0,9
R_xbIW3svny9yqQmt,6,3,0,0,9
R_2Yf7KLUoeXMMrbq,8,0,0,0,8
R_BKVsHQDNTTrR5Rv,8,2,0,0,10
R_3Phvvm9s3bcOYjx,3,2,1,0,6
R_2Qhwzr6mXD9xNjX,1,2,0,0,3
R_1OCfJbPemc3GJ7e,5,3,0,0,8
R_2xWPesvXboL5hs6,3,6,3,0,12
R_2Ec1HM6vWnnn5Fv,8,1,0,0,9
R_2dPWqnNxTB7bhit,6,3,2,0,11
R_1hSxIwTBejoch3a,5,2,1,0,8
R_O3DEq5DdWMcAGK5,6,1,1,0,8
R_3iFkfrsfIuz9caV,8,5,0,0,13
R_r2QE6ZaOrcawHIZ,9,1,0,0,10
R_3KJCsekdO4WM26M,1,1,4,0,6
R_6gur7hzva57pZa9,2,2,3,0,7
R_30jbd0G5kmlcCyX,8,2,0,0,10
R_2ZNDyJ8jRd3Wz1X,6,0,0,0,6
R_3O22yqdS5aUTf25,6,4,0,0,10
R_2dZnVaeKG6zd8ry,2,4,1,0,7
R_31ibCcLUovlx9F3,5,4,1,0,10
R_3JxfJodjvCW7CqB,4,1,1,0,6
R_1puFvaFQmBnQGkZ,4,5,0,0,9
R_1CqFF5RmpTtXc8d,4,4,0,0,8
R_333ac8wqtOpkUUK,5,4,0,0,9
R_2tDtvhKFpEU6oQ2,0,2,7,0,9
R_3iJtGyc3xTsXV2j,6,1,0,0,7
R_2ZQrtPW2aZI4lJL,2,6,1,0,9
R_a4MpwYBICpwGqoF,10,1,0,0,11
R_vohWgSEBr3iqwEh,1,1,2,0,4
R_2aabHaZ9ujmDOuB,6,4,0,0,10
R_10IWiKASGyhWwjB,7,1,1,0,9
R_5nahEUvQL40rYtj,3,6,1,0,10
R_1Q0hVbBmO1ZVZLX,2,4,1,0,7
R_3iCNtnGyP3Brjn1,2,2,3,0,7
R_1MY4J95VcvMS5al,1,2,4,0,7
R_aXmPNsPomKt3IGt,2,4,0,0,6
R_2pK2jj9xC9xb0p9,8,2,0,0,10
R_3HBt45Un6v1uqAl,6,4,0,0,10
R_1DZHwlIAeW4660K,7,3,0,0,10
R_1DUuZxTmfrodStv,5,3,2,0,10
R_3R27nL0quXWKdl4,5,2,0,0,7
R_wQP9Md5mY9kO1od,3,5,1,0,9
R_yl4iVZ4vOgIhr3j,3,1,5,0,9
R_1QltQJ8PBv4RMKO,7,4,0,0,11
R_2AG7s4IH2vChnvz,5,5,0,0,10
R_3jSCYoVJmfRJT5F,7,3,0,0,10
R_oZXbOlnUYhcDQ53,2,4,0,0,6
R_xh1UgkTkzkzyRWN,5,3,2,0,10
R_3J8x6oUdGah269Z,7,2,0,0,9
R_3NyvZ6wRUJh60P0,6,4,1,0,11
R_1QuOkL1cw98ONNA,2,7,0,0,9
R_tSD6o3kIck45Tcl,3,2,3,0,8
R_z0vdB4uAwRZCjlf,7,3,0,0,10
R_2dRUPcKbxKu1wMq,7,1,0,0,8
R_Cfwn3D0YzvjlPpL,5,5,0,0,10
R_1robx0MKTGFs9va,3,6,2,0,11
R_2bNJ5m7xnQpDQrj,6,5,2,0,13
R_xy0qdMyW7nHOM2R,7,4,0,0,11
R_WD69cILIZTGmSyd,5,3,0,0,8
R_1pVAeTqpMtOg5xc,2,5,2,0,9
R_2bIeAhzCM2a4mIJ,3,6,0,0,9
R_1oGQmxuzDjsS9Dg,7,2,1,0,10
R_12Q5c9RYzeg85Ci,7,0,0,0,7
R_1OjZsnpiw85ML6H,4,5,0,0,9
R_qLxtLyrdNZkUYIV,5,2,0,0,7
R_2uGCArR0xKoqgNz,5,4,0,0,9
R_yC0LIv2BxELaKOZ,0,3,4,0,7
R_3qKEtS2UgQGawck,7,3,0,0,10
R_rfsswReuemL84wN,2,3,5,0,10
R_pzmvgBPdnRzL3gJ,6,3,0,0,9
R_2SvpJ6rhxC2TpQp,9,2,0,0,11
R_2xDYJ7pxLYfD7pC,2,6,2,0,10
R_32LwWX3jCfxdZWo,5,4,0,0,9
R_2q3nomkcvNW66AO,3,5,1,0,9
R_2sR58qhlkmdZRsV,0,2,5,0,7
R_3hmsTDYtgOt03ry,2,4,2,0,8
R_2AF0bgERCaW9FXZ,8,1,0,0,9
R_1jOeHKzj1GnMnVl,6,5,0,0,11
R_29nYSeFAqaMwX3Q,7,2,0,0,9
R_27B8GdWchcc1Q7g,8,2,0,0,10
R_3kG480VJRHGxZMq,3,5,2,0,10
R_1JVm5yfCkQtrBid,5,4,0,0,9
R_3nTVQ4ICX5ArDXf,5,3,1,0,9
R_vBLVLBN32RCJPu9,9,1,0,0,10
R_1X4LyBqwUZfT33j,0,2,6,0,8
R_2b0L3qxF5P65pjO,7,2,0,0,9
R_3qxlFPs8MFPGXca,6,4,0,0,10
R_DV3bUX2nc4PwJLH,7,1,0,0,8
R_3O7CbDtoCOgd0ls,6,2,1,0,9
R_V2JJaS0OvdhxQuR,5,4,0,0,9
R_1LvvIdO6slmmpSL,6,1,0,0,7
R_2pRfMRX5KTiBMFi,8,2,0,0,10
R_1KOLNjwt3GAGiOt,4,3,2,0,9
R_2PnWkK7l3T6QgCi,7,3,0,0,10
R_3mkNeXlETh1zIRl,5,1,1,0,7
R_3hsu4Y4UCkeFMf7,3,3,3,0,9
R_3qU2UeShabWEz22,9,1,0,0,10
R_3hApNepQUpuACdU,3,7,0,0,10
R_2TztegyzJqTGWbO,6,3,0,0,9
R_2dAMwihdNj1dnfc,6,3,0,0,9
R_2OO3rRaUnnKORAJ,3,3,2,0,8
R_232yZSitIvmRGgO,6,1,1,0,8
R_2dtgZiMfFjtI4lI,7,1,0,0,8
R_1QF4RnBZeK1JE0e,7,3,0,0,10
R_yJTvGi9x3uIerC1,6,1,0,0,7
R_3Wzq0j05TEsVdoR,4,2,0,0,6
R_1pX0MgaZP8HqRwR,6,3,0,0,9
R_sL116xl2fISywKZ,4,5,1,0,10
R_3G3M0TNgDwa6FqY,2,3,2,0,7
R_2CV25VRnvtOttXO,0,1,4,0,5
R_80yEJl3g8YxkbGF,8,1,0,0,9
R_32PZxNHhuxhre4c,4,4,3,0,11
R_2CJTjvFr6tUO0X4,3,3,3,0,9
R_307RHTx09FzZkNW,1,2,6,0,9
R_tXqo49rvpGUyZmV,6,4,0,0,10
R_OKkry2LIbZgXFzb,3,3,4,0,10
R_3npjLXkZ44cDOuQ,3,2,4,0,9
R_2V7UwOmhQ1RzfA2,4,2,1,0,7
R_1gHmxshsuU1piJR,9,3,0,0,12
R_2TZWIs7HsNpp7ew,9,0,0,0,9
R_22zSPOJQSwBvsAi,7,3,0,0,10
R_1Nk7KMXefopVjYh,5,2,0,0,7
R_1EgrwL18R86Ndkn,3,4,0,0,7
R_2Quo6UEosViRikC,5,4,3,0,12
R_2asH0hqvLSYpGLZ,8,0,2,0,10
R_3lWAQJ2Q0QWwdzP,9,1,0,0,10
R_2aeiKY5Ub0Dgupd,4,3,2,0,9
R_2R2mlwWuFfDH4GZ,5,4,2,0,11
R_2c5YliYU8qdjms2,2,7,0,0,9
R_2w0sUUoBF3QXNbu,0,1,5,0,6
R_31uAc12iRWSXIRc,4,5,0,0,9
R_1oj0v4kg1ydLaQj,6,4,0,0,10
R_3oKESC8oRJgLoTD,5,3,0,0,8
R_2z6zpbzX4cyJBrz,7,3,0,0,10
R_dokNmHgnR2vQOVb,5,2,1,0,8
R_12J9KhrFN1GVG62,9,0,0,0,9
R_3efXAhAliBpFJ3l,5,5,0,0,10
R_BsTtzQBW1NRShuF,4,5,1,0,10
R_1FEOGhwXEBE7ZjG,3,1,1,0,5
R_cTQcbR5dRaKNVfj,6,4,0,0,10
R_3fTYwCRVnuliFUO,2,4,4,0,10
R_2CDgHHBYJoBHuD9,6,3,0,0,9
R_3qpXAJLr4IkvxWF,3,6,1,0,10
R_2ahn8YhhkoMkVVS,3,2,1,0,6
R_3EsWXaHMe8YrfbL,1,2,6,0,9
R_3QSnp8JGUAovAR7,4,3,0,0,7
R_3MDpetXM8V8SavH,2,7,2,0,11
R_1mz7qbO6IBUDpmK,6,4,0,0,10
R_1HkH2yhRNlvH86x,6,4,1,0,11
R_8dAy6BvhNE7cbuN,6,3,1,0,10
R_2QAtyDv49H9yEUv,5,2,1,0,8
R_3BJVPPwxNwfAajv,3,3,2,0,8
R_3sbOBycqwjmaCzD,4,4,1,0,9
R_3kBNy9NpyrcNn6M,5,4,0,0,9
R_2thaxRZgRAsi6GV,8,1,0,0,9
R_3il5kfyX34HmPTz,10,0,0,0,10
R_28YEimTRV2l1eNY,3,2,4,0,9
R_DvJLNVkVlP8T3tT,8,0,0,0,8
R_2rPFinsvHQIuvM3,5,4,1,0,10
R_1Nnody3Tg4L2YTx,4,5,0,0,9
R_1pYGRkWUUmHAY3s,4,6,1,0,11
R_1DAc8cGZPmuPyMG,6,2,3,0,11
R_wNnELLjUsL3I3Hb,7,5,0,0,12
R_SOTnq5BqlHqBXln,7,3,0,0,10
R_2SAYbsL6kGzj3hJ,5,0,2,0,7
R_1IY7Al5Rwrv8VDd,3,2,0,0,5
R_efx5oiFjbA8jWbT,7,1,2,0,10
R_2eQ1BbT1JYKlr4S,2,3,0,0,5
R_338DuTzVgmnYHl0,6,3,0,0,9
R_3r263jKJQ9HeSYH,5,6,0,0,11
R_1hNjTmuIXnkuYIo,6,0,0,0,6
R_PSBSSOT1GOfctUt,8,1,0,0,9
R_TeffIRLrRInuVbz,7,3,0,0,10
R_1KwEBFe5r0mkKSc,1,6,3,0,10
R_R9PdceEBFz7AJFv,8,1,0,0,9
R_2wMQla8i9hnYMKi,1,2,5,0,8
R_R3KG9MDlLbgnxAd,5,6,0,0,11
R_2e2WMeXoSV911PL,4,5,0,0,9
R_2f0ZcrOgOdEXX41,5,3,0,0,8
R_RklWx7MgSrvTXSp,3,2,0,0,5
R_3pm7n0k1xZZBeRz,2,5,3,0,10
R_21B2KqhkymctyNA,4,3,2,0,9
R_2dYLMgoe1nqdgxj,4,1,2,0,7
R_3s7Gjid1H4wCFkT,8,1,0,0,9
R_29tTNQT2gybhjXo,5,1,1,0,7
R_bfO9CJE8CDNs1Q5,1,1,5,0,7
R_3foPP1oR3iKIESE,3,3,4,0,10
R_1LTnLU3n5b0zKMv,4,2,0,0,6
R_3qQKKoaxa286MeM,7,1,0,0,8
R_26xvV9t5qSaQEiR,3,7,0,0,10
R_1hW2x24BhuqBCZj,8,3,0,0,11
R_2v5Gxm9PQEQl3TV,6,3,0,0,9
R_3snTI8ornFQHrBI,7,3,1,0,11
R_3dKsPK01u71jfq2,5,0,1,0,6
R_2TmHDGFcROjj23a,3,2,4,0,9
R_2wcy7qkhpdyMFCD,5,6,0,0,11
R_2qwmAgxvbKxoYEl,5,5,1,0,11
R_1DYARyIziJGNz1a,3,1,3,0,7
R_2TGJR79Xk2atk1o,5,4,1,0,10
R_VVlgSqkzsO9IF9L,3,4,3,0,10
R_UsWH6upjprRcTCh,6,2,2,0,10
R_1LAkJcdZGUaYTu0,6,4,0,0,10
R_2dDY3jTk8IcgAmY,0,1,0,0,1
R_4NkBZ66FgT2DESR,5,1,1,0,7
R_25sSwkS3T1TfyoS,3,4,1,0,8
R_25RvyXjj7XQxmhN,3,8,0,0,11
R_XvvOocORklODKkp,6,4,0,0,10
R_1OqSzu8BfdYlvud,4,7,1,0,12
R_3OfhVBCsavXlyL4,5,4,0,0,9
R_2zwpzU0PSUY6fDu,5,3,0,0,8
R_1CgdpaifvTM4CQd,4,3,0,0,7
R_1Lo3mCtDXX31lWl,5,5,0,0,10
R_1LwoFSw5v6YKfWY,7,3,0,0,10
R_1FsajpkQTjN6DAi,3,4,3,0,10
R_1puMCXrYF41lqIs,4,4,0,0,8
R_ptNs7yh6oflteQp,2,4,2,0,8
R_28GsKoU7QAXbXoD,1,2,6,0,9
R_3Po8gGUsuEOFWXs,0,4,6,0,10
R_2zLKXbTEOYZIA4G,4,4,0,0,8
R_114HinUeQFlliWd,5,4,0,0,9
R_26kwiW6EdT3Xvt9,7,2,0,0,9
R_2wMFzXYnOvfb8lQ,4,4,0,0,8
R_pFeNxlxLj5a8F3j,5,5,0,0,10
R_1o6ziBLrK9bE51S,5,5,0,0,10
R_3kzH55SbuiDFcld,6,3,0,0,9
R_2WPfYJscuLnDNFc,5,4,0,0,9
R_3qPCuYRVWnFwcMu,7,1,0,0,8
R_3GlYG3PklNVRoMz,7,2,0,0,9
R_2SxCjqSAw7rduP9,4,4,0,0,8
R_1FKbccKv9WSvsU1,7,2,0,0,9
R_2dGrEFOaWFhezJZ,2,6,0,0,8
R_9Y8Vcr6R3LIw5dn,7,1,0,0,8
R_O74uho6KByWIbBf,8,2,0,0,10
R_3pfLYI4dgKDlbLB,5,3,0,0,8
R_31EDKVZjSHElLMt,5,3,2,0,10
R_1mKoQzCnGe08GqK,6,3,0,0,9
R_2OVknM5ibatJx88,5,3,0,0,8
R_3GBMjP7qNoryBeO,4,5,1,0,10
R_2Tt9pr2GKwEsWpB,1,4,3,0,8
R_Cgp5TBFeTw0CmeB,4,5,0,0,9
R_VRcqbOaYVZZzJXr,1,1,6,0,8
R_3G7YKtLpAVqQO0Q,1,7,2,0,10
R_2fqXcD94v2JxP8T,5,4,1,0,10
R_3LkeLtf9D97lWLO,8,3,0,0,11
R_3O7eSKpqzkfevqe,3,8,0,0,11
R_10IBIrUoeVOKcjf,8,1,1,0,10
R_24kMIeZYNJVzgnw,7,4,0,0,11
R_2EEG78Le1JKgfQl,5,4,1,0,10
R_2PpyqddaswjWN4M,6,1,0,0,7
R_3e2dqVw7WIydJvw,5,5,1,0,11
R_210cd8ki62T3L40,8,1,0,0,9
R_2fHSOjoCmJcAvpV,2,1,0,0,3
R_TdY3m4JuDqRRyA9,7,3,0,0,10
R_2YJ5KKZtcQ2mtVK,2,5,0,0,7
R_3lr9XzYeEPjJ1V9,0,3,4,0,7
R_332oOL2bQEoSVMt,4,7,0,0,11
R_ZErTjd9t8YTfeKt,5,5,0,0,10
R_1E0XmC2DTHaqtIt,7,1,0,0,8
R_2VDs6e9exQA6QNV,4,6,0,0,10
R_1P1RQueFmVof63u,7,2,1,0,10
R_3sn8RQ3imCRf8wd,2,5,2,0,9
R_2rvWb0o9an03s6S,2,5,2,0,9
R_3maah4b7Obe5c5i,6,0,1,0,7
R_1CCHPdODVScTW8p,5,6,1,0,12
R_XFz1hEeMLGgX7I5,1,6,3,0,10
R_ZKRU75hNdi7Deal,7,3,0,0,10
R_25ziyDu810k2xfO,3,7,1,0,11
R_1Het04DKZncn58W,8,2,0,0,10
R_2EzuNUEEPUOp7Bh,6,0,0,0,6
R_2t3jdK654yloUfH,10,0,0,0,10
R_2c7QKNKy7RkqTLP,8,1,1,0,10
R_1CelBR3iNNDRUfY,5,1,0,0,6
R_2XoAU6RAD03EBew,7,2,1,0,10
R_sFlr4nXnhUjVQXL,4,4,1,0,9
R_rpgHlyWPLdj4tlT,1,6,2,0,9
R_Wp5XioR8HcQURk5,6,4,0,0,10
R_QaouWBZugWunOYV,2,3,3,0,8
R_cXV2nNbB8BrSLjX,4,4,0,0,8
R_1rxBVkBDA6BTvbg,7,0,0,0,7
R_2BA2JffX4IgTE1K,9,1,0,0,10
R_ehRL1ggunFtgLw5,4,4,0,0,8
R_2TzRdr3Xo8TsXj8,6,3,1,0,10
R_3PKW1ZLr0CxQDpf,5,5,0,0,10
R_bdTcY4M3aDYWwg1,6,0,2,0,8
R_1Gyro6I2q3yYqAT,3,1,2,0,6
R_1FsJH8DzK5oioZf,7,3,0,0,10
R_2DT9EPX0z6VALzp,2,0,5,0,7
R_PYd3a9WxFKmCVqh,5,1,2,0,8
R_WB4jsnoH54kQGkh,5,5,0,0,10
R_Q6qaRMqS12msOpr,1,2,6,0,9
R_1i9ySJK6bonBLAG,5,4,0,0,9
R_5dSXUV0sM0jONcB,3,4,2,0,9
R_2V1MwHMWqYBLxh3,8,0,0,0,8
R_A6uQceiPhrTsLIt,4,6,0,0,10
R_2D1byQGfKVDKOHW,5,3,0,0,8
R_2EFBGeiXA1DmKwn,0,7,3,0,10
R_e4hV4fex2KCie0F,8,2,0,0,10
R_VQlat4MWYjqFXLH,4,3,2,0,9
R_1FLMV6hVX5Ji4wV,2,6,2,0,10
R_3lVX4tBEe504oIN,5,5,0,0,10
R_2Cs25NmRk2YSc85,3,5,0,0,8
R_24wmoRLabxYvWzm,10,1,0,0,11
R_WrJZE62G157Wwb7,1,3,0,0,4
R_scg3kFQ8yG0ZawN,3,8,0,0,11
R_sRaEYOc5IaSwWg9,3,3,3,0,9
R_3JKGPyxIgWOB2Ux,6,2,1,0,9
R_vB29FVAr7x4RXZ7,6,2,0,0,8
R_2t9HUDe9R13eZio,5,5,1,0,11
R_1cZErbqsttCFU9i,6,3,1,0,10
R_6nD6Z2Ej5GPdWCd,4,4,1,0,9
R_PCBlZWUSEfLw3hT,8,2,0,0,10
R_1eKIaKWIfcHSibh,6,4,0,0,10
R_p4U8eDo9Tdx0LJv,5,5,0,0,10
R_6orheumHQuhhDDr,4,5,0,0,9
R_1LcKSjxaetCICgB,4,3,3,0,10
R_2wER5qq9hNziIns,4,1,2,0,7
R_XpO2TacVEpIDNMB,7,2,0,0,9
R_3foZubugSZUdIXo,2,4,1,0,7
R_32L8W4w0bmTi6MM,8,2,0,0,10
R_rjUlHkU5a4yGFHj,7,2,0,0,9
R_oZQJxxgqXK6O6v7,6,4,0,0,10
R_1jVsev0Fibh9Q3f,6,2,2,0,10
R_3qDMwn3BFSaIRo5,7,1,1,0,9
R_2Ys8EHPxXCvhCaC,3,3,2,0,8
R_2qE2rJVFfrgUiuA,4,6,0,0,10
R_33x095mIS9Fw0Cn,6,3,0,0,9
R_1NhnXXFg2JjEQcT,5,2,0,0,7
R_xbhWNsESSTbM7zb,6,1,0,0,7
R_1Kj1DutBgjocPBN,9,1,0,0,10
R_2sQKXJTbJZG8aGJ,1,4,2,0,7
R_cG6i4mOUZlkKCml,5,2,0,0,7
R_3nDaQsJjqxlgY7a,6,2,0,0,8
R_3lssBbWoGggMbpi,2,8,0,0,10
R_2QAhHoWf86VKCFM,4,2,1,0,7
R_spnZpK7zRpTpKyR,5,0,5,0,10
R_2uWKUFTNYKcj7UH,8,1,0,0,9
R_3qUPWlZkMFJqk82,5,3,2,0,10
R_3KNRZQSJAj7Rviw,6,1,0,0,7
R_2Ey0h6G2EG3qCha,8,4,0,0,12
R_839VdrssBVurG6J,7,2,0,0,9
R_WBT1F9EDIfQfYNX,6,3,0,0,9
R_1GUKHZFl7o13RF7,7,2,1,0,10
R_2WwJbDfv8PTEFCI,1,1,5,0,7
R_wY7O80Wxv8k1KSJ,4,6,0,0,10
R_3dDQSkRk8VpvBRM,10,0,0,0,10
R_2bGWWhbaGsvnmRM,3,7,0,0,10
R_2f8N7xRQP1pfHk7,6,4,1,0,11
R_yllM3NlWM5kTNYZ,3,7,1,0,11
R_2Sfcli16T877smA,8,2,0,0,10
R_CkrjgVYTzUHUKzf,7,3,0,0,10
R_3R9iYcb4u7b5NdN,3,7,0,0,10
R_2Y5qrWxB8foZW7e,5,4,1,0,10
R_2Ttp4ZOxOQ3IQNs,5,2,2,0,9
R_08kP2b9lL6GvyMx,5,4,0,0,9
R_2aQrAoXlySiXXhB,6,1,0,0,7
R_1DGphr88CabyhxG,9,1,0,0,10
R_2uyC8gyBzsN80j9,8,1,0,0,9
R_2OVHHMlGqrB77zz,3,5,1,0,9
R_e3uMfMCjDxFFDih,3,4,4,0,11
R_bw68LjXiPgiBsWZ,6,3,0,0,9
R_1QgzYLu5YROhsg8,9,0,0,0,9
R_2P6wtSYFlh3w4Dr,3,5,0,0,8
R_3EALdAjGQ9kLJIT,5,3,0,0,8
R_2TosVF0zPcPkLOI,4,3,1,0,8
R_1MPUPyFc3QYkzCb,6,2,0,0,8
R_1jMUuMYTNtBXVZX,1,7,1,0,9
R_3qvNvV3jW0aPiVB,6,2,0,0,8
R_Dc9hXYVnnkxlrEJ,6,4,0,0,10
R_2ydMUfjGj9ox1h9,9,1,0,0,10
R_25Hl3BfJI1DdgO4,8,2,0,0,10
R_3snR6AUbAHrDWdW,9,2,0,0,11
R_3knfi0TveETed8M,2,2,2,0,6
R_3PYoUiYOGkSsgja,7,4,0,0,11
R_2q4uQNIKN5jCSuc,3,2,4,0,9
R_3R1NvlKt5OJE5R7,6,5,0,0,11
R_2RVNmeu7NPLaj7k,3,3,4,0,10
R_2ANN7lN8ULhtSei,5,1,0,0,6
R_2RWCxHmlYoK34zL,2,3,0,0,5
R_3JznxX7PXipjAy4,0,1,5,0,6
R_CgiBBMceZaMGCd3,3,7,1,0,11
R_3EMDnfTGGzlIbty,7,1,2,0,10
R_2uf1rSv9JKLJaUN,6,0,0,0,6
R_302HMSFiVsmZDJC,3,3,2,0,8
R_ThXHUVfeFBnJCdb,5,3,1,0,9
R_BRQPBMtMoBCh2Kd,4,3,1,0,8
R_cFMOuEN2mMhxYRz,3,3,3,0,9
R_1rNWIs8pRPy1cqd,8,1,1,0,10
R_1CIxMyJHfVYHwxc,2,5,0,0,7
R_1LzJjf4VZkRbcFr,9,1,0,0,10
R_2teYqK57VQ8E6gK,1,4,4,0,9
R_2tgk2VwEtonrAgc,6,4,0,0,10
R_3NV4FBKgE3ORXS2,6,4,0,0,10
R_30uucdbiUQLrlAA,8,1,0,0,9
R_3OrCjGPEMzzvtyL,7,0,0,0,7
R_SVvvje4NWIUr4xX,1,0,4,0,5
R_3JlYaqd1D1hWF2L,4,3,3,0,10
R_5pRwENyu3qLvUWd,4,1,2,0,7
R_30vIqNQbkiswGG4,8,2,0,0,10
R_1lrDvMpFxxR2Iau,2,4,3,0,9
R_3EomJsrzxK80M2A,9,2,0,0,11
R_2787N1E04U17Aub,5,4,0,0,9
R_2TmzbKgO95AWZ4m,9,2,0,0,11
R_2TS6cKHIHiaprmQ,3,2,2,0,7
R_3Uk3O89qiIKUWCR,4,3,3,0,10
R_3NVClTu6XzBkRyY,1,4,3,0,8
R_33rkKy3ct9otZG0,6,2,0,0,8
R_vlxJcsH3j40jaxz,6,4,0,0,10
R_33rOvEAz72NyFsp,5,4,0,0,9
R_sdJmGaMemJT73q1,5,4,0,0,9
R_3kpQg2l1sSKpJEN,4,1,3,0,8
R_w59DaZFqzN8i1sl,7,1,0,0,8
R_UJY8y8D1zTZeXQJ,4,2,3,0,9
R_DoeIzvoQ11iL6U1,5,2,0,0,7
R_ZgVUlJAYdpI6B0J,4,5,1,0,10
R_1OjAz3ttTZRhgNg,3,2,1,0,6
R_2b2x7wbtVB3kxqe,10,0,0,0,10
R_2sbc5TpIPy6UzpT,7,1,0,0,8
R_es8nAGEeyRkcAxz,3,2,4,0,9
R_1QL9k5X4902J25d,10,1,0,0,11
R_2BnsmgWhvdclSst,2,6,0,0,8
R_25AX7CCEXfElV6H,5,6,0,0,11
R_2VPiHbksXcaDH0p,4,3,2,0,9
R_A7EAwUajn5nkkE1,7,3,1,0,11
R_1lmfHhEKLDlxl5d,6,3,0,0,9
R_2XiCU1hd6YokIci,6,4,1,0,11
R_1pA98cRXpuYgOIo,7,1,0,0,8
R_RyOQLnE3t0UWsiR,2,4,2,0,8
R_33m2HNicH8iREm7,2,4,1,0,7
R_UbYPbQjFxUBgXAZ,4,3,1,0,8
R_1jHrrixJGRojEfc,5,4,0,0,9
R_54qhO1k93t2p51D,2,3,1,0,6
R_eLGpVbtF8rLtrk5,4,7,0,0,11
R_3Ptd86EHFrDix4A,5,1,2,0,8
R_3UXcdqsjQ03Mpsl,7,3,0,0,10
R_WqS1ZcBbzTT90Rj,1,0,8,0,9
R_1fko4YSHpUnxkgl,4,5,0,0,9
R_WifKQyFWD28P6AV,3,3,0,0,6
R_1GuV2ib473z9eb9,6,3,1,0,10
R_9Nz5BrUN4mZsp9L,9,0,0,0,9
R_3OEWRO5Cz5CxDyx,9,1,0,0,10
R_UYCmrj4AmIXdYlz,1,2,4,0,7
R_20VwBAlmka74JUW,2,7,0,0,9
R_1LdqXEE9ya34Nc1,0,4,2,0,6
R_2sU4VV6DylMk7lV,4,4,2,0,10
R_9ZXxN3mQ39EcJkB,7,3,0,0,10
R_296oA06RSEzB1nW,3,2,0,0,5
R_1GPRULoGVSWdmoG,5,4,0,0,9
R_CaIYgM0lhNeRayR,3,3,4,0,10
R_CmKzS46rrCllWKZ,5,5,0,0,10
R_2S0Mte3tqdgtrj7,7,2,0,0,9
R_3L0jkbAwi6uAE8a,5,3,0,0,8
R_yQk0CH34z870Dvz,3,7,1,0,11
R_3L57NcIlwpRfeND,1,4,4,0,9
R_ssY3PRm1ZmdKsHT,3,1,2,0,6
R_O1DYIbd3qkHtcoF,6,3,0,0,9
R_2aVV5e4FpM1EuK7,5,4,1,0,10
R_1EdpnopXruOAXvj,2,5,3,0,10
R_3nN1x6TvLZe4cUz,1,3,3,0,7
R_2ATCouBTA5MmSjt,5,7,0,1,13
R_3KCTt4q1Irdavy4,8,2,0,0,10
R_8Gup3frIApl13pL,7,0,0,0,7
R_001sUYpc634fTnr,4,5,0,0,9
R_3k7BnFy2C4gWd1l,6,4,0,0,10
R_1i2SDIDlApTNmUs,2,4,0,0,6
R_2WwfUIZ3N1oeymq,5,3,2,0,10
R_AGrl2v5nVJ1vlRf,8,2,0,0,10
R_1relrYk9dH57lTd,5,4,1,0,10
R_3G8l0lQqp8Gf1PP,5,3,3,0,11
R_3MnXN3gte4XM3Yg,6,5,0,0,11
R_301CmSNpb5mwwNf,9,1,0,0,10
R_2QVS4sidm8e3Q0M,6,2,0,0,8
R_0wac9wppSvwUZ8J,6,3,0,0,9
R_ea0G8ZEgAESE9BT,5,2,2,0,9
R_3nATfnTH9EVz1By,5,3,0,0,8
R_3ITdagNJB3URgUX,4,6,0,0,10
R_ZmXh9R7wIHbNIJj,2,3,3,0,8
R_b9JOKNjTAKT2lZT,5,4,0,0,9
R_Q3P1i0wB4ovN9qp,8,2,0,0,10
R_2xwPGiKEFBDJxwu,6,3,0,0,9
R_b7NBGn2sG4jcX73,4,0,1,0,5
R_AzgQDjsZsR3XOqB,6,1,0,0,7
R_r2qbvKxV1IjA4RX,6,2,0,0,8
R_2Y99a7QsrRVByXa,6,2,0,0,8
R_2EgD1ArWKi2zdoF,6,4,0,0,10
R_yL0m5svHFE47TIB,6,4,0,0,10
R_eXRWVgNcFU5IvnP,1,4,2,0,7
R_2OHHPiQZ1GIcZNm,7,4,0,0,11
R_RErntwYWsAIgnKN,2,1,7,0,10
R_2V2BJZ9mk1x6aUu,3,2,4,0,9
R_z6znN4jSEMdpIQx,4,3,0,0,7
R_1MMPNc1oUSoNs0E,1,5,3,0,9
R_2Qzh6ZApWiJwZSv,9,1,0,0,10
R_vIdIwDUYROU39ol,7,2,0,0,9
R_1KcXIUOI0jUQ0qk,5,5,0,0,10
R_5pCAslbc6qc2tBn,6,4,3,0,13
R_2P06wePQELfR1Xy,9,1,0,0,10
R_27kRKi7yrY8uOny,7,1,0,0,8
R_1cSOK8AlTpZXFqi,2,6,1,0,9
R_ZpzDu5pqVvdaTMl,5,4,0,0,9
R_1OlQUGV02tZQ2pK,3,5,2,0,10
R_O6uTxykSckEh9sd,7,2,0,0,9
R_1q4DZyibf8f4NG1,5,2,1,0,8
R_1jZAEXj6eFx6Vod,5,4,0,0,9
R_1IFYi2dSbNpXZJh,8,7,0,0,15
R_1cYYHrVmaPMxwHN,5,4,1,0,10
R_USkVHOLu7Hgd2qB,4,3,0,0,7
R_3MizUgrhGSRr34k,6,2,0,0,8
R_2v0oFR2oyYePQZr,7,1,0,0,8
R_1ONekPBjGxQpNJg,5,4,0,0,9
R_3CNTrnm6S46OWfz,3,3,3,0,9
R_2QghQoGxL91h3Mp,7,0,0,0,7
R_UrREVhbb0iJDMwp,3,4,2,0,9
R_1n1QAggMxP3dVsp,3,3,0,0,6
R_2pJrmT1vYIwDHLr,7,3,0,0,10
R_1DwiMCqeiWIM2bh,3,5,3,0,11
R_bDGOYpPioEQyQqB,7,0,2,0,9
R_eXJmxV4yZBIDE6R,1,3,4,0,8
R_bEkj61P1WjeQy8p,5,5,1,0,11
R_2D5HEJBlmYePDS5,1,5,3,0,9
R_WBA3DYO4wkWDgKB,2,6,0,0,8
R_31vcafW8V4b0Mr5,8,2,0,0,10
R_1IAtWFqMKkU7STI,3,4,2,0,9
R_1NzGDhsuLS2FoK0,3,1,4,0,8
R_UyJBJFkfEYWZv57,1,7,1,0,9
R_OkE5S3Y0Jrmmq65,10,1,0,0,11
R_1pLSfspfoFxCOE7,7,2,0,0,9
R_3L85TeWw28n2kIW,7,3,0,0,10
R_3F41bIise8o4qbE,5,5,0,0,10
R_0BVAymdpOMhJQoF,2,0,2,0,4
R_3G8J9pwUklqDd7q,4,4,2,0,10
R_1hKXuAKhSMy0zsX,7,1,1,0,9
R_6LLjT44mkyWhEwV,5,5,0,0,10
R_12hdfUCaWUzIcYH,3,5,0,0,8
R_3PjdUTQmPBjkcof,8,1,0,0,9
R_2Yrmxe0mhHmDc6Z,6,2,0,0,8
R_31NvVuXncedji1o,5,5,1,0,11
R_XLGLze8mHHCnUY1,7,2,0,0,9
R_1jpPzJF4kk60JKN,9,1,0,0,10
R_1HvuHYfQDeJdtrb,6,2,0,0,8
R_1N8qiFfhQzzEVbp,7,4,0,0,11
R_295PwIVYkwRx7Ev,3,1,4,0,8
R_1pnxvkOWL64zA1A,6,1,2,0,9
R_1KwpzXz4gotzeKU,4,3,2,0,9
R_3nvWLnkbjQTu7YC,3,2,5,0,10
R_1Cjz4n8dPYgalmY,2,5,2,0,9
R_2ti2tOc8ZIObK1o,2,2,4,0,8
R_W9jPw4z6K0cK3aF,4,2,0,0,6
R_qWrxHbDKIrKdqc9,7,2,0,0,9
R_2SwbVv0PxcfnnNd,4,6,0,0,10
R_3qsSfE901N92ZKw,2,4,3,0,9
R_1PXhCEOi3PMbQ6g,11,1,0,0,12
R_1Fy0cWhGuC6wBnD,8,2,1,0,11
R_0kqvaaTOHRgo1JD,4,3,0,0,7
R_2ByXuvLkp0SjTPe,3,6,0,0,9
R_55vkJqk0E84C7SN,6,1,0,0,7
R_2wBs5RcrJCUEJZT,4,6,0,0,10
R_1goHVy2FMhdxxwh,2,5,1,0,8
R_3CUYxXzN6qIJMYB,6,3,1,0,10
R_2rZdgc1Y2IjAS3t,8,4,0,0,12
R_3sdln1TtFhBQfD3,6,3,0,0,9
R_2uK6ONpPsdUCzNt,8,1,0,0,9
R_3iD6sEjHftWD2Gw,6,4,0,0,10
R_30bZVbzxXeNuSFv,4,3,0,0,7
R_eqT2mUV7b6IFcOJ,5,1,1,0,7
R_1QGuKmtAMp3Oq0y,8,1,0,0,9
R_2XgMJoNZb5UiCyO,7,0,0,0,7
R_3IW5T6fxfUeKYz8,9,1,0,0,10
R_23vD8WfzetNVXk5,5,4,0,0,9
R_28Sr2VzSbGLJTY9,5,6,2,0,13
R_2SGeEu84KeoAeDD,2,2,5,0,9
R_2rG709sRJwQmIaW,4,7,0,0,11
R_a41aI04CtloJ9PX,1,3,1,0,5
R_3G3qa1Try2YU6AD,2,1,3,1,7
R_1FLmwpUsaSEoFs5,4,7,0,0,11
R_p6QlwrXAE6OpD57,7,1,0,0,8
R_2rkHiFCfDz7T3Ko,4,4,0,0,8
R_ebouG2U5Eqx5TCV,1,2,3,0,6
R_1DpXtP2OT6lE9Vo,4,2,2,0,8
R_Wj80lNetxG39gjL,3,5,0,0,8
R_ZaztlOYwO5Ec61r,4,5,1,0,10
R_1QaSGM9PXQb0Q5f,7,2,0,0,9
R_Dx9jOPnN0pgh4LD,5,3,0,0,8
R_3sgJ93Tw1UkUTnd,4,1,0,0,5
R_2iyo30zAJcP7mdX,6,2,0,0,8
R_1Fzlt4NNQN6bi3A,3,3,2,0,8
R_3PiQpKaYiRX98yj,1,6,2,0,9
R_4OrpDnBnXelBkPv,4,4,1,0,9
R_3hbH0i8vf8wxd0p,5,2,0,0,7
R_1OriOlU1wdH5xFf,3,3,2,0,8
R_2B9HukeJDcyRbt3,3,1,3,0,7
R_1pJSipLNB2Ecxmu,7,1,0,0,8
R_2y1Se5isGAs7tn0,8,3,1,0,12
R_3Ny4VbO6dBPhMSf,3,2,0,0,5
R_29s8ANSdfDuCEuT,5,5,0,0,10
R_bPAmnmkiv46d9gR,3,4,4,0,11
R_sAVKueaQrY8zw1b,6,3,0,0,9
R_R8LkiMV7FSKsPvz,2,1,6,0,9
R_PCnhbfRCH3ztjz3,4,6,0,0,10
R_dogLafqtjPWmulj,3,1,3,0,7
R_2fKj0yfGUs7IP6p,6,1,0,0,7
R_31YoG5Coincp4jq,7,1,0,0,8
R_22zup0YESHizQnB,2,1,6,0,9
R_tEOHypxphccQ9Rn,6,2,0,0,8
R_enZhmPspymBLG2R,3,4,0,0,7
R_2uWkF7xdwDC7x7k,7,2,0,0,9
R_3BPSSUAmfUH7LmF,10,0,0,0,10
R_1BLSWPyWyoYN5vz,7,1,0,0,8
R_sdGiH97mKafOtKV,5,5,0,0,10
R_29aGGxPj3TRVXy2,2,3,4,0,9
R_2CsvDifDDWqWArw,3,4,1,0,8
R_2B3sXCj71r5Y5a4,5,3,0,0,8
R_3Ja7yNEzYy5cjUT,4,1,4,0,9
R_2rSpqMemA44i2Lc,4,5,2,0,11
R_e4FX1jupDQzG7E5,2,4,4,0,10
R_Zgku6WzSOPR4mjL,8,3,0,0,11
R_1CpQCdAKO5J0UsB,4,3,0,0,7
R_1onGyQ3P6I9SlON,6,1,2,0,9
R_xnOktGpgB7UU9Wx,3,4,0,0,7
R_2uKjYgsLi9Bub5t,6,4,0,0,10
R_2VOO3Ji2VtASXpG,8,3,0,0,11
R_w4wK0F7edlhojhn,5,4,1,0,10
R_3MgvqxousvHvV0Z,7,2,1,0,10
R_2qFf6cbpGwiJjt8,4,3,0,0,7
R_2zo8ezEY1FwrCUd,2,5,1,0,8
R_bkJPiMKE7TgTTmp,1,3,1,0,5
R_1Lh3VipXCWhr3OQ,6,2,1,0,9
R_2zqLUZPl2ov5RcH,2,4,4,0,10
R_1N2DfKjstj0jlWE,1,7,0,0,8
R_1Kw3VffRwLUJERu,7,2,0,0,9
R_2aS5XA5Vs1ssODZ,9,0,0,0,9
R_1EZPVbLuurpYsdU,4,6,0,0,10
R_1HcppKvNRonq2Nm,3,1,4,0,8
R_PvNPorhLjCfnv9f,6,3,0,0,9
R_3g60tiQpQ9fFTXS,4,6,1,0,11
R_1l6oln0FVClSkfB,5,3,2,0,10
R_1MNeFCUFCVE7dMm,7,3,0,0,10
R_23VH3DzVmr8USVs,5,4,0,0,9
R_cBDbjG861wornxL,5,5,0,0,10
R_2zCH3YuoddskpzW,5,4,1,0,10
R_QoCw9TY7HFJkI5X,2,3,4,0,9
R_3MopBLtMWlaTzJi,3,3,3,0,9
R_33vDxfKhLXimRYI,5,7,0,0,12
R_VOtOgJO6aVXzxRv,2,6,0,0,8
R_24jx8FbpWVMlsMk,4,3,0,0,7
R_3F4fiocmlwWsKZE,5,4,0,0,9
R_3koVEsYuqIwL0jO,10,0,0,0,10
R_1JL7ZC8UPtArCzK,2,2,1,0,5
R_1dLmuPrhAR4qd75,7,3,0,0,10
R_2WMyHXcShszNIXz,5,3,2,0,10
R_3qVZI1g6e7ZQ8X9,4,2,0,0,6
R_3GiYMhU8EySNr6T,6,2,2,0,10
R_RJliY7iDOlTJwiJ,4,5,0,0,9
R_DCvI2iCUXJIn7BT,5,2,0,0,7
R_O24eRSTKSkfaZsl,3,5,0,0,8
R_Xzc11L3nWs5Cm1X,8,2,0,0,10
R_2CJ0tf5i8HqX0ic,2,4,2,0,8
R_vxj0rXFwIrgTsBz,5,4,0,0,9
R_2658p2aTPR4kgCb,4,5,0,0,9
R_bC1gBVALhEx5Hxv,9,1,0,0,10
R_2am2XtNifJOs9VY,3,7,2,0,12
R_278YK6LXitPfzT3,1,2,5,0,8
R_1HhNu0yvofJUMAj,8,1,0,0,9
R_BAqopI9YtNWgQyB,4,5,0,0,9
R_BxkaBcmD6pmcDkt,9,2,0,0,11
R_2dFPApN74YDFTWa,6,3,0,0,9
R_plwBgfacxaU81Sp,5,8,1,0,14
R_1hMCHs5Vxw0ID39,7,3,0,0,10
R_1jZGn5pPMXcqrZP,6,0,0,0,6
R_WfCKduS2XPOJHjj,6,4,1,0,11
R_3sytVznWXo7okUJ,7,2,0,0,9
R_2aRilDGHahWUe9l,6,4,0,0,10
R_2pVOD75Ja6vuzSh,1,4,6,0,11
R_2fcTd7ql3ZqPsCg,6,0,0,0,6
R_OvOkKMZmTPvzfgt,3,4,2,0,9
R_12Phu5hjSihjtvd,5,6,0,0,11
R_WvznnHHstiIE6Ax,6,3,0,0,9
R_TdxN1Y4q55gTBkt,4,4,0,0,8
R_3suJ6dVzPEHTivo,6,3,0,0,9
R_2ypBk7akCvVIs6s,3,1,3,0,7
R_1BQKTdGvUApPMc6,4,4,0,0,8
R_2e8dz2O2QFD0McP,1,0,7,0,8
R_2rSY4Zo4babI3OG,7,2,0,0,9
R_AsuoL8eeSoMfEZ3,4,4,1,0,9
R_1Nzzo8YfMbEB3On,8,2,0,0,10
R_1o6z6YJCiy3gTKq,3,6,0,0,9
R_216DDTJ1OS2rHmD,5,3,0,0,8
R_00VjS1b0KnxylPz,6,3,0,0,9
R_3JxUJBTVtGFr4sz,9,0,0,0,9
R_3iWIEmDV5WVbC5g,7,3,0,0,10
R_XBoLLTo2jfBYEet,1,4,2,0,7
R_0ALf8IO4xTikttn,5,4,0,0,9
R_2VHZsAYlupTax5T,2,7,1,0,10
R_1rplIOET3NnlBIn,7,3,0,0,10
R_py2gUa24YPMwVEZ,7,6,1,0,14
R_3IS4XAaArCBL7EA,8,2,0,0,10
R_AuoMuxMmUw420Cd,5,5,0,0,10
R_pMCQvCaD3BotgoF,5,3,0,0,8
R_eJNKR9YsJEvlRFD,3,5,0,0,8
R_1IWsGUygkaZiGzx,6,2,0,0,8
R_soHY86zBJg42zcd,7,3,0,0,10
R_1NtzdMZuMD2F0Rz,5,5,0,0,10
R_27DR22vRrPhZeKO,7,2,0,0,9
R_1Iv14L6wg62mgDz,4,8,0,0,12
R_RyliKzkrtCNz21P,5,7,0,0,12
R_ROKzD0IpW58t81r,1,1,6,0,8
R_2Y95lpxoV9m5sJy,3,6,1,0,10
R_86Qmr3m5FxUWEz7,6,3,0,0,9
R_3NyonSem7OYilNE,4,4,1,0,9
R_2eUqtsQoOmuXja5,5,3,0,0,8
R_9TwAd63A416OAlr,7,3,0,0,10
R_3PnaCQUBPCctSDS,7,3,0,0,10
R_3jdIxrvW38XDneX,2,9,0,0,11
R_1Gy9QLin5tou96R,9,2,0,0,11
R_2wMNlNcAFslrZKt,3,1,6,0,10
R_2YXMRoRLys54TGg,5,5,0,0,10
R_qL6ZEwxZG7bZehP,7,1,0,0,8
R_2v6Sb43jRLb0TZO,0,0,8,0,8
R_PTiSprUi9h84oY9,8,2,0,0,10
R_1P5yB7ljw99DCnU,0,4,4,0,8
R_4PlfGlmCLqEKqD7,6,3,1,0,10
R_2y2XeKXsbYRLj40,2,4,1,0,7
R_3hFMlyAUwoJUPI1,9,1,0,0,10
R_20MaSamdw8T4w4B,3,2,5,0,10
R_1CwFE8J4JpwxsaK,2,7,1,0,10
R_by09SuNFII6C1WN,4,4,0,0,8
R_3CHGzOaJq6W1X7o,5,3,2,0,10
R_3HAnJDZ1exm4q7P,6,2,1,0,9
R_aXCPmXCymU58q1X,8,2,0,0,10
R_viPUjST1XhuhYgF,2,3,1,0,6
R_1JVYdfGprqYHzBM,4,3,1,0,8
R_2CI1MeBy7cgVvUq,4,4,1,0,9
R_ClAhGooMADAKARr,8,3,0,0,11
R_3kqgCvBsYDYBRGg,7,1,0,0,8
R_3HNTBq51PdNFsyD,2,6,1,0,9
R_1OPK3bGdgQTviVo,8,1,0,0,9
R_2fBWW7qeSrmT9a4,4,4,3,0,11
R_2aA1cQaMPJnypAj,6,4,0,0,10
R_1QB0hmtamm5HmNI,5,5,0,0,10
R_2zkImDJQOb6gO2F,6,3,1,0,10
R_DIQg4KU2VFfEVjz,3,2,2,0,7
R_1dN2CmFv5Tt3aLO,4,3,2,0,9
R_2rpT5r6dxvEDAOB,6,3,1,0,10
R_12SdWkSaNrZyTyw,3,2,3,0,8
R_2aRibgSdVFTRKQw,3,1,0,0,4
R_Om0ITIw36wvkKPf,5,7,0,0,12
R_dnbNU4k9RfazirT,6,3,0,0,9
R_1GvTlapl9392xGD,6,3,0,0,9
R_vOFc3g3bJnY7mff,0,1,5,0,6
R_vYNSxsRz9B7ZPwZ,4,4,2,0,10
R_4ZNuqELS1n9CnOV,4,1,0,0,5
R_31Hoy05sSLyaaAc,4,4,0,0,8
R_1qdGUwpMhzN6aMD,0,1,5,0,6
R_wSpu4t7ZJ7gmGrf,6,1,0,0,7
R_1HiY8XeT46JW1cj,3,2,4,0,9
R_3DwYKekaF0iZHdD,7,5,0,0,12
R_1QFOGnTg2fiEkLX,8,1,2,0,11
R_3JlQWSpMiuF7nK6,3,3,1,0,7
R_2agJdIR2vLSk6jr,7,1,2,0,10
R_3NFnMBXbBvhZkCa,3,7,0,0,10
R_DTyjWbghtSbvr1f,8,3,0,1,12
R_2xx8bnsP5UQmrLS,3,6,0,0,9
R_vpZaZrZhy2dyfbb,5,4,0,0,9
R_2CjQPcetdt6KBVI,5,5,0,0,10
R_3nvzyvCsjtfRsbR,7,2,0,0,9
R_1DOODFBwdU83ucq,5,4,0,0,9
R_3hA6oPz05theFLL,7,2,0,0,9
R_2eOVpGD9sKVsHOZ,1,5,3,0,9
R_z1IZf4CRd5QLYaJ,5,5,0,0,10
R_UDCkjWihkOIog81,7,0,3,0,10
R_24MILhnmVorA0jY,3,4,1,0,8
R_2q1mp6ez416yn8C,5,4,1,0,10
R_3emq8x0h8xcRmEu,5,3,0,0,8
R_1HdIeHqPLBkRNFn,5,4,2,0,11
R_2DYrOm63ObywiJQ,7,0,2,0,9
R_AAiI0iIhDqw7mlX,8,1,0,0,9
R_3MFZTACqadZfbJq,8,3,0,0,11
R_1ltXdL9E2yA1XeV,2,5,0,0,7
R_1pyzU7ntvQm6kfE,5,4,0,0,9
R_3DeEiJUp6JVktWg,6,0,0,0,6
R_3I6NjwtQieJX21A,6,3,1,0,10
R_3kGP2WnjjngV0M3,4,1,0,0,5
R_24oxKCrawY9xZ2C,5,4,0,0,9
R_pJW6kqpLy0F0YZH,5,4,0,0,9
R_3iCodxzYYhzPH2M,6,4,0,0,10
R_719SUd4dq8ep4hH,9,0,0,0,9
R_eS7QmCXzX90g47f,4,4,2,0,10
R_W9ue26gXI8xgHQt,5,4,0,0,9
R_1gLsr546UPHRKKP,5,5,0,0,10
R_02LfVBMvtfdIish,8,2,0,0,10
R_RVRP8rOVTl6OjMl,4,5,1,0,10
R_yKksoQ3hxJzfwgV,3,7,0,0,10
R_3KW0reuHYLPPQdC,3,4,2,0,9
R_3PMo8nlZsJMqf4g,5,2,2,0,9
R_1juCzvlqGUrXKVb,7,3,0,0,10
R_2Ybrfmo3Spb1T8x,3,5,2,0,10
R_3EQhiI0NLMXo9Ce,5,1,0,0,6
R_1mCsKNtbRBa4L9s,6,3,0,0,9
R_2aQ4mmQV464XYSf,2,7,0,0,9
R_2VyeTBe81CzGwFa,7,1,0,0,8
R_1N9CyMw9DrafsJ6,0,2,6,0,8
R_DBrKU1fcju7BDiN,3,4,0,0,7
R_UAx0MbTnvkdfip3,9,0,1,0,10
R_3EKAoBBfOTvpR7Y,6,4,0,0,10
R_2Br0oKjKKHpEKzt,8,3,0,0,11
R_3L6jnxCB5rGdO9g,7,1,0,0,8
R_2veTQUmk1d7aZYg,3,5,1,0,9
R_1KjLcuPO0gcX1Tm,5,4,1,0,10
R_1PRVpt09TJIdooQ,6,3,2,0,11
R_1I6tJhYB2q8o3LI,5,4,0,0,9
R_2zqZqJT78BTxxM1,7,2,0,0,9
R_2uZAU1FtOCI9HHP,4,4,0,0,8
R_x9HWI2ni6ajE9JT,6,4,0,0,10
R_vf3o529aynALSpz,5,2,2,0,9
R_3KrtLPJ8lv2bAWc,3,3,3,0,9
R_24jAbfXnTF7J5Wk,7,3,0,0,10
R_YcycJxzHnW645tn,2,8,0,0,10
R_2aXYSRlWb0hrxZi,2,1,3,0,6
R_1OkwKC281s80pup,6,1,0,0,7
R_2SjGUHDJUN1nZoX,2,4,2,0,8
R_2VOwpthG1qVEiY2,7,1,0,0,8
R_1cTBqSXbf1nINoB,7,2,0,0,9
R_3MheEgxLy7zPUpp,5,7,0,0,12
R_5AyMAX4HGXBl4xr,5,6,0,0,11
R_t0alOluvu5yPdyp,2,3,2,0,7
R_1NtBsEEOmtZ4lGi,0,7,3,0,10
R_1N21tfPviyHaWwg,7,1,0,0,8
R_1iljLc6BLVxc5Iz,4,6,0,0,10
R_1pRtBr2ktPzt5Dy,2,3,3,0,8
R_cBDbMgLuAf9KnZf,1,3,3,0,7
R_1H2zp1XfBPDoGmm,7,0,1,0,8
R_3nTcI2pQRbFpvOZ,2,6,1,0,9
R_3Ny9ttJWwJAu7iQ,3,6,0,0,9
R_3QRAJGWlk8Crj4F,7,2,0,0,9
R_1jWaPHF7vQVJjIB,7,3,0,0,10
R_1LU7H81CzAHj6lg,2,5,1,0,8
R_12FSeMn5sHTQiTB,3,5,0,0,8
R_2PkgvNu1abdvRdA,8,2,0,0,10
R_DI9kpWeWRxL1F3b,8,1,1,0,10
R_3Deps9vMJew4vrb,0,3,0,0,3
R_XBAtNx0jwZvJljr,4,5,1,0,10
R_DIBw5dTPfqzKHND,1,4,3,0,8
R_1jJkfUPs7fTv3xY,4,7,0,0,11
R_2ql4I8MYyW0KRJs,3,6,0,0,9
R_1EasBWc2fVWFRJu,6,1,3,0,10
R_2c2syXLMbf4XRz8,5,3,1,0,9
R_1NEB6j09m8SVj6B,6,0,0,0,6
R_dj7vuaoQejXae77,7,3,0,0,10
R_3sdbnnjo0E8cB7U,7,3,0,0,10
R_0kZV73Imb0VoaE9,10,2,0,0,12
R_t0qmKAg0NmseW2Z,6,1,1,0,8
R_3eyuPEEL8P8c5db,5,2,0,0,7
R_1psTfMmAI14gVkh,5,3,0,0,8
R_NVAPbnrN45zuZ1v,1,3,5,0,9
R_2whOu6LWm9GIe3S,3,6,2,0,11
R_5tJ2V8v3e82jyCJ,7,4,0,0,11
R_2e9D79WmNgkkz4x,4,7,0,0,11
R_3EPRTgHwAC7r6Z1,7,3,0,0,10
R_z2SN3U754sN4r8B,0,1,1,0,2
R_1JJB1JnQwgH8CZa,4,5,0,0,9
R_2xEjoUaSxFtKfW8,6,1,1,0,8
R_3rH8KkMegVnrO2J,7,2,0,0,9
R_22zhXYKafFHqEnd,4,4,0,0,8
R_0NHwzbtIMUHtIRz,7,3,0,0,10
R_1Fy8HVSDf9dZ5lG,5,2,2,0,9
R_1Ej3thFE08Ap3hd,5,4,1,0,10
R_0Nwa5pLrWT8Csvf,0,2,3,0,5
R_2e59mbIjAnCFbpf,4,2,1,0,7
R_2X5TpAuI4G8Y5zj,10,0,0,0,10
R_1IfTXQbBN0ABaPj,6,1,2,0,9
R_1C1Jk84latsBO2N,9,1,0,0,10
R_10MF6Z5M88j3gWh,8,0,0,0,8
R_2DZ8olVtLaBTp6K,4,4,2,0,10
R_3g5Dwi4QLtEW2m7,9,1,0,0,10
R_TuZbjs2VpErXbfb,4,1,0,0,5
R_1Nay8nBEszpowZG,5,4,0,0,9
R_Tc0NuvYd6wIWSnn,10,0,0,0,10
R_3iDaWZDYv21u9kj,7,0,0,0,7
R_AEEKrz2sBAEoJy1,2,1,2,0,5
R_2v6MfBb5SjkNJv0,3,7,2,0,12
R_9BpJNZTVnvJu1tD,4,4,1,0,9
R_2eP5n3hqOHacwTq,11,1,0,0,12
R_3gYhUaxoqnMJe49,7,2,0,0,9
R_AiWPTw5X3tAuOUF,7,2,1,0,10
R_3rThKgbtd4D2aGu,7,2,0,0,9
R_3Rm6lDjKQLsUqdq,6,3,1,0,10
R_1eEmO5MbFrFLqZy,5,3,1,0,9
R_1LYU0XBXKeebS66,8,3,0,0,11
R_1gh9Ib3L500busM,6,2,0,0,8
R_3FII64mAZpPOFhc,6,3,0,0,9
R_OxIydPpKWCsElZn,7,2,0,0,9
R_3hG5eXt0wdHUdz3,4,3,0,0,7
R_Zg9HrOspLwZ4wkF,3,2,2,0,7
R_RmlCEbbwx1IkI25,4,3,3,0,10
R_qXgE9lY1ttbRloB,6,5,0,0,11
R_2wuiB2iEjD0vQna,6,2,0,0,8
R_2dyfQnizGw8Mu0K,3,5,1,0,9
R_1K2wHRlMUTvCFuF,6,0,2,0,8
R_1q8nzBBloiwioXH,6,3,0,0,9
R_2CwB7kZvZnmMXfv,3,3,4,0,10
R_1KpsgfO019Lg53v,5,5,0,0,10
R_2uWDBGQBbXbIMhc,6,3,0,0,9
R_NUMYFw7Gfaq08G5,6,2,2,0,10
R_3lsRg1iuxpj1rVs,7,2,0,0,9
R_e3cWOtvyRBovxYZ,7,2,0,0,9
R_1FfEJRJi6zCEF1O,7,4,0,0,11
R_2TC4AvSal8vlu0y,5,4,0,0,9
R_2QSbmSFyzMnh3s9,5,3,0,0,8
R_1iaQe7FawUkeceW,1,1,7,0,9
R_2YL0b8COUZXUOLk,7,1,0,0,8
R_5gtSzMfTGe2TPcl,3,5,0,0,8
R_3Pp3HwQtKFmF5QA,4,4,2,0,10
R_2WOo5tK1tr8lE0O,6,3,0,0,9
R_3J3K9ZjgOn4LmUR,5,2,0,0,7
R_4ZmYwfqyb0Kjl0l,4,3,1,0,8
R_42cJPNEj26XqCA1,5,6,0,0,11
R_Utsf9lX7o88uIvL,1,3,5,0,9
R_3D6kGlvesBzCqz1,7,2,0,0,9
R_bkp3kSIAI3Olxsd,3,4,3,0,10
R_1gqnLq8KXUojfWO,6,2,1,0,9
R_2PvWOm2OFNAGAJF,6,0,2,0,8
R_cLUnKC9hI7LwcMh,4,5,2,0,11
R_3h42AQkzCbAziqx,2,6,0,0,8
R_3hhHYpSZYxVq1VM,4,1,4,0,9
R_3KPgo6VbuMwmX87,7,2,0,0,9
R_1mFbNqZ5po7tGTi,5,3,4,0,12
R_1Qto7MoCVJTkck5,8,1,0,0,9
R_1obXTYd8tW6q963,8,0,0,0,8
R_2xEFyHN9xewmkjy,2,5,3,0,10
R_3koxSTjcjjrzBa1,7,3,0,0,10
R_2f7W76cGOu6KXV7,6,4,0,0,10
R_2P5t4PMaFcXgGhX,6,1,1,0,8
R_3HtW45YfbvkZlWz,2,7,0,0,9
R_0OFxLstlkkETR7z,4,4,1,0,9
R_2BbbFnjcaK7Iz48,7,2,0,0,9
R_3J3MH287O90i8iR,3,6,0,0,9
R_OwhfiDfoFyiUV8Z,3,6,1,0,10
R_2eWGYVP612R78xd,7,0,2,0,9
R_xbVIrLvhalqL8s1,4,5,0,0,9
R_2ux0jyQvEtm7v01,4,1,3,0,8
R_R8qzqpu5R28fbfr,2,2,8,0,12
R_2tzin8ohxKR4BRB,6,3,0,0,9
R_3I0Hp63FkY0Riql,8,1,0,0,9
R_1oFFivaYEeMJSl2,4,2,0,0,6
R_XBppyTffwon3MbL,4,4,0,0,8
R_eRvXqp8MVvovZYd,1,5,2,0,8
R_2Ei3YPRAn28Kwci,4,6,0,0,10
R_2rAUTky9BImReLc,5,5,0,0,10
R_UzEtx1BmTEuHuff,5,3,0,0,8
R_3xG6nhsunDKkyfD,6,2,1,0,9
R_2vkrLY9YAgdlyKS,6,2,1,0,9
R_20PqjEFX9adqGUN,2,3,4,0,9
R_31N0OJoIHPvpE3v,9,1,0,0,10
R_AG7dxFWVUnKdDbj,3,7,0,0,10
R_6JZIrFi4EHoSdjP,9,1,0,0,10
R_3t3mxAJSgwORpYd,2,4,1,0,7
R_32QvyQkE7RFdVev,9,1,0,0,10
R_1gb80XPw1FnylMG,3,7,1,0,11
R_2EiAJIRaEVEQbUG,3,5,2,0,10
R_2eWFsxzFaedZSg0,6,3,0,0,9
R_32PeLFGRYfTwfYB,5,5,2,0,12
R_2ya4ioi9bW1low6,2,4,1,0,7
R_3GBe2jQkLEfdK0X,4,5,0,0,9
R_27kG1Lp8vsAWa7R,5,4,0,0,9
R_3JrCOzeN3HSFrHz,9,3,0,0,12
R_3FIl97djdmLf4Vn,3,2,1,0,6
R_2aLZcMI1OygLaSH,5,2,2,0,9
R_1LCIMdU93Juqcjs,6,4,0,0,10
R_2fpUPdSTVqAxt0w,8,1,0,0,9
R_3shMJSXEMDimggE,5,3,1,0,9
R_31gvUI3MbYURpXP,3,2,3,0,8
R_p003Nk9VWo2Ngrf,9,0,0,0,9
R_2ROOa2S7R9xpypg,9,1,0,0,10
R_2YeKaDi0ihmLpJc,7,3,0,0,10
R_1lahYBkHCzMjSoM,2,5,1,0,8
R_3jSBOAPDqI4TSew,7,3,0,0,10
R_3GcBQ8u46A0zcBR,4,6,0,0,10
R_O1kf7HWHIG29o41,4,3,0,0,7
R_tJtM5ouov3qjrLX,3,5,1,0,9
R_0pMCfUJeC2OoBKp,2,7,0,0,9
R_3m9kNvbmQDsFiK6,0,1,2,0,3
R_12Mb5IRfL75FZPP,7,3,0,0,10
R_xiwj3gp64Eh8mdz,5,0,4,0,9
R_3G1zO8vJ5dU5Vco,3,6,0,0,9
R_3CDXAOL53c7fBbR,7,3,0,0,10
R_eY63WBkncsfeaUV,4,5,0,0,9
R_r8x14M1w2ddhLLH,10,0,0,0,10
R_2wyuttvVLNdF2yu,3,3,1,0,7
R_1riERGoI4kiUKmC,1,2,3,0,6
R_1kZDnxRAkhGNexS,5,4,0,0,9
R_1jJrMRdF2CFEsTH,8,3,0,0,11
R_2EioDw1CsjdCvrL,2,3,5,0,10
R_3DiJstTDcTQhU4I,5,4,0,0,9
R_enfPnEjKr0saBb3,3,5,1,0,9
R_1hRnQGly4XZj889,1,3,1,0,5
R_22LnnwwLkXiA1El,10,0,0,0,10
R_1JW0xuiOgp7u6Hf,4,3,1,0,8
R_2bHns2IL9ELocgi,6,1,0,0,7
R_3iETCb1IcaUKB1C,5,2,1,0,8
R_1f8irjHaEmMH5zE,8,2,0,0,10
R_10IQ4DDw6Iv0kfE,5,4,0,0,9
R_39RfW116yKyZH3j,5,2,2,0,9
R_2coP80X1My1SF7Z,6,4,0,0,10
R_87aXaUumnduMzL3,4,4,0,0,8
R_2f0XAeH3X8o4cT0,5,4,0,0,9
R_BCYzxQlsWzqcprz,5,2,1,0,8
R_3LhhKo8vMyt0xL3,7,3,1,0,11
R_2OUAZekIe5OvslN,5,1,1,0,7
R_28YffLvB5BSIfL1,4,3,2,0,9
R_vcvnPhWT8VTsb5v,9,2,0,0,11
R_POjnK6ytUYzNhLz,6,3,1,0,10
R_1qVWUO0oW1P0u0a,7,1,0,0,8
R_31pwiMbZ0F6i4Tk,7,5,0,0,12
R_3KGCE4edAoO7D3i,8,0,0,0,8
R_2690bHVwT4B6GXH,3,3,3,0,9
R_BSpzdPQUIoOolA5,5,1,2,0,8
R_xtKyIhIJH71NHMZ,8,4,0,0,12
R_1jP2G6OgBexfOw6,5,5,0,0,10
R_An5rIoV3TLbijnj,5,4,1,0,10
R_7QIDcoZXRmbXXQl,7,4,0,0,11
R_2zHlvAa5tMatcn1,7,5,0,0,12
R_2dSevAJ97NoDGzc,3,3,3,0,9
R_VQFukWnxz0EGafT,5,4,0,0,9
R_1GUngEFmbqMDr0I,7,1,0,0,8
R_0O3dtmMWu1cxwbL,3,4,2,0,9
R_1Sz4XmOnph4KfMB,7,2,0,0,9
R_3Jgt0OciufNqtKm,5,3,0,0,8
R_1GvqqMM1WAcuKIE,5,0,0,0,5
R_1gAvpudBsV4AzLU,0,7,1,0,8
R_1fdC9VZeGGnbpyi,3,6,0,0,9
R_2uVbxzqQYCcr9mv,5,5,0,0,10
R_3MnXk4AUFEIQjdn,5,6,0,0,11
R_2b1xMSa61jAN72Q,4,4,1,0,9
R_29lZKTBFFTU8Nwj,0,5,1,0,6
R_5jA97ijUd7hqmXL,8,2,0,0,10
R_1dN9hcybrE4FE5R,6,3,0,0,9
R_3qV9HUwUhQWixB2,2,3,0,0,5
R_sbsLhJbSz3bidQB,6,2,0,0,8
R_296pMNiDq2tWfxE,8,2,0,0,10
R_2rqCqSZb6f9TYYl,5,5,0,0,10
R_1jZdr1VBepui6kb,0,3,4,0,7
R_12EB9jm6eNUoYUM,7,3,0,0,10
R_r0G5yHMasHmDdD3,4,2,2,0,8
R_aVqfd9GtCEilT4B,4,2,1,0,7
R_W8z4UWlbJBJTLXP,7,4,0,0,11
R_1laUVejRtI1TQAb,6,4,0,0,10
R_x9HPFzKlCkbdkyt,6,4,0,0,10
R_3nSeTzBz93flIQy,3,2,1,0,6
R_2arkaExF9P5Weyp,0,5,2,0,7
R_saKhdGbQsdTwsdb,6,3,0,0,9
R_2QVWA6ABlk4VtXV,9,1,0,0,10
R_3hb6FakHULFD0yE,5,1,3,0,9
R_28GkOJgEsS4EMMv,6,3,1,0,10
R_246GbiOSLJv6F41,1,5,1,0,7
R_30iQgC6c2EdBNc4,6,3,0,0,9
R_4Usvjctb9dpRitr,3,3,4,0,10
R_3qIM1wuVDfoy9Z5,8,2,0,0,10
R_3KO66tFiKHceGRj,5,4,0,0,9
R_3M5TKf3alIrhB5C,4,4,3,0,11
R_2XgtJwpJ8vsDETp,2,5,2,0,9
R_3JKJooBMBKml3Sc,9,1,0,0,10
R_3FImUheDeFkxtAw,8,1,0,0,9
R_12ajsTqxKFICdpT,3,6,0,0,9
R_2eOJNJCqNhpcQVI,3,2,0,0,5
R_UROCNQqB5vV6MCZ,5,3,2,0,10
R_eX88xDcVyyRLGlr,5,4,1,0,10
R_3O2Hy7dH32aec0S,5,4,0,0,9
R_2A05DMcvyIfCRYQ,8,0,0,0,8
R_3nxvbXpaE13WGZO,1,4,3,0,8
R_2eQMGm1YlDlvpUj,1,3,3,0,7
R_28OIqxsyH2ka2dh,1,5,2,0,8
R_2Pcmn5eylgZnpbf,6,3,1,0,10
R_3hzp80bxL7iv0Sj,8,1,0,0,9
R_3oHer0IRYXvwyqC,5,4,0,0,9
R_2fE9qi7Iwsei0vY,1,6,1,0,8
R_6fj2S30mKbl3MhX,4,6,0,0,10
R_umNHOLdgS6JIZu9,7,4,0,0,11
R_6R4GtjemU8uKKCl,4,3,1,0,8
R_2SHOa0Q7NISCkDG,1,3,3,0,7
R_9NZMAGON9670gQF,3,1,5,0,9
R_2U0h8neljsw4TJY,2,5,0,0,7
R_2f2KYcoMGz59M2x,5,3,1,0,9
R_BwT0fLMJeVRCuVH,2,7,1,0,10
R_2f8Nf7eeaH7xsbK,2,5,0,0,7
R_XGiB6f2aFMjk8iB,4,3,0,0,7
R_3nkhHtRjJ7TocXg,6,3,0,0,9
R_1LGL0gEs1iuQdKe,2,7,0,0,9
R_22E5KzEqExa4nXB,7,1,1,0,9
R_2t3VxokE3gjNe52,6,4,0,0,10
R_1H2htgyXHsgbe1j,4,3,0,0,7
R_OpRkHuwIToaHLUt,7,0,0,0,7
R_3QLYOe3YrEL9uGL,4,0,1,0,5
R_2ANjX1LHuhVBjSM,7,2,0,0,9
R_vDD0ebjDAtwbgrv,3,4,2,0,9
R_3qffvEQvh32tYYi,1,5,2,0,8
R_1geeYypMuw1gGe6,1,4,4,0,9
R_3GCDM66SHUHYlbN,7,4,0,0,11
R_2ToSsaxKFf0yuQB,9,0,0,0,9
R_2aCDGztStWtl19z,6,1,0,0,7
R_1GV1aIMAwg06ePj,3,8,1,0,12
R_3qIQMzB4HWa14D4,7,5,0,0,12
R_31gb9kHHld07B2G,6,3,0,0,9
R_3izk6B58Zd19oqe,1,2,5,0,8
R_262yBdu1yA2SGL7,6,3,0,0,9
R_33s9ZvORSUjlFi6,5,3,1,0,9
R_2uODJUQamTvX5EP,4,2,0,0,6
R_3iq0dR6Lj4czXpY,6,4,0,0,10
R_qUywWkfR8vwA6Zj,4,5,0,0,9
R_D8IOAqhnhOkWMYV,8,2,0,0,10
R_vdJiXbiR9dnxY89,6,2,0,0,8
R_1gu8f0KhLk4Vk4u,5,2,2,0,9
R_30qqlM8rUXd4jEJ,9,1,0,0,10
R_3CPmzjY4ls1a05y,1,7,1,0,9
R_2Vl4cUOEgTbh1Ol,9,1,0,0,10
R_Raj7AJnYKgTzntT,2,9,2,0,13
R_6Ek4UuJta0AFilr,4,1,2,0,7
R_2zkZmfSGLYmuWx0,7,2,0,0,9
R_3kif1ToDB3ZZZQ4,4,5,0,0,9
R_3J9I6FFXiJGsNtM,1,3,5,0,9
R_XTIpKHoJQwL7uUN,4,5,1,0,10
R_2uU7j9kHp8jWnHA,7,1,2,0,10
R_2dF3etnTeYaGNzt,7,0,0,0,7
R_3n1rQXuvJaux5Yu,3,6,0,0,9
R_1mfq2mtAiAeen2B,7,4,0,0,11
R_2b2EXUnZlZpcY6I,2,4,0,0,6
R_2e3VSmbWOEm4pce,0,6,3,0,9
R_1LUwiWUE2dC37Bq,5,5,0,0,10
R_3kbQwW4TtWb9Jd6,4,2,2,0,8
R_2WVJmH7fJs62CvS,0,4,4,0,8
R_2uwdu48vT6Ph8BP,4,0,1,0,5
R_3fQbTIs0rPIZ3ET,7,1,0,0,8
R_1cY76s1VgiCuCLC,5,2,0,0,7
R_2cCLuAYna9cJ8Y9,4,3,3,0,10
R_2BnfmvDdnvAYIgJ,5,5,0,0,10
R_3hzFeZXO1pKmCxI,3,5,1,0,9
R_2b1WuhZXpJ4Rii8,3,0,6,0,9
R_YVpJgarCBM6qkKJ,6,3,0,0,9
R_us1tdqflS9GB0tj,8,3,0,0,11
R_1dbPaChDulb5N1U,6,4,0,0,10
R_WllHxAgJe3sPuOl,5,5,0,0,10
R_6Ru1HzJBa1UYO4N,5,6,0,0,11
R_2D8fA0xqhz2rFmr,7,0,0,0,7
R_3ELx080tHVWKfA8,6,2,0,0,8
R_2aVL0WJgczigNuB,0,1,8,0,9
R_2v7JIw0DS6bc7oX,9,1,0,0,10
R_26hVPbh1IIKPsMJ,6,4,0,0,10
R_qInG5fIw9H6SOFH,5,4,0,0,9
R_3MGbj3VmkLmTabt,4,4,1,0,9
R_b3LdCE0104S3Iit,8,1,0,0,9
R_1OE3eK5eY0dQAr2,7,1,0,0,8
R_21bwxxzxRWiE0Ez,3,4,3,0,10
R_1hVTQaBPVbvnRUm,4,3,0,0,7
R_1IuBDxs8WZrjsN6,5,3,0,0,8
R_21AILUlMT8WZAQM,4,3,0,0,7
R_10NHFyVmNwuL9zD,5,3,1,0,9
R_2ZUEsBCkd72t0wJ,7,3,0,0,10
R_2D6RnUH6outB7g5,6,3,0,0,9
R_2fGTA0mOYoxaSAB,6,1,0,0,7
R_3dYWeRrVQ1KIiZA,6,4,0,0,10
R_2q9FAhI7rY9PYaD,6,4,0,0,10
R_2aVmlrMXAoG9kxK,6,5,0,0,11
R_sXnn9D9hOZOVTsl,8,0,0,0,8
R_28MK68Y3fh8PKBX,4,7,1,0,12
R_yjXFIXRxEsTF1dv,6,1,0,0,7
R_1LhgkRqzPbOAIzg,6,4,0,0,10
R_W04pPVLdDZ6lK9P,8,3,0,0,11
R_2UftIPIzMjh9BjJ,3,4,0,0,7
R_3R46GilVVKdSOFQ,7,0,0,0,7
R_1kLBJYM7U0jcy8F,2,7,0,0,9
R_WvqdjXFkTb0aXLj,7,2,1,0,10
R_DpWTvKwbCFaR2U1,6,3,1,0,10
R_AjuwzfgPN9YSczn,7,2,0,0,9
R_9StvmA7892TsKWt,3,5,0,0,8
R_2118zxIf2uWmsiu,1,3,6,0,10
R_3niM21qF3M5MyFV,4,2,2,0,8
R_2w4C5gIBAe1SwAJ,6,3,0,0,9
R_7WjErOTmH5WXMZ3,2,5,2,0,9
R_2t46IttIve5MIVz,6,5,0,0,11
R_3HSKahNuUG7Kfl0,2,6,0,0,8
R_2rVEgAwsuqRs0Ct,8,0,0,0,8
R_3lSanMvvASi5wu1,4,5,0,0,9
R_3m4U0npnsPKqNII,0,1,5,0,6
R_31KHbQKAOERDY71,0,3,3,0,6
R_25HHFCMwrPpNO2s,5,4,0,0,9
R_3O6cL4RrhyNbA4V,6,3,0,0,9
R_3kvvVzRsMbOb0ac,4,4,0,0,8
R_3Mlpm0SycQhxPym,5,4,2,0,11
R_2woGZ18bq6xWgNp,4,3,1,0,8
R_3FRHMNahMGTm4y0,2,5,3,0,10
R_3lAEhC9NdPceEp6,5,3,0,0,8
R_1nYNfk0F48HfzPW,4,5,1,0,10
R_D2e3DD4Pz9ss1ih,1,2,3,0,6
R_1QaRdJQsAhymn1E,8,4,0,0,12
R_2wRXOoszIfpe7aZ,4,4,1,0,9
R_TdWtxey7mJljpAZ,7,0,0,0,7
R_0lypd0rZEcMXaJX,10,3,0,0,13
R_SE391yGARx7JbgZ,2,4,3,0,9
R_3hnX9cPJ72fvEwS,4,4,0,0,8
R_RxdAQX04hKMGoVj,5,3,2,0,10
R_1FsTpgL2qdq0ien,7,4,0,0,11
R_AAkgq0G8MP4SBzP,1,2,6,0,9
R_OO9ovTY0kMGxgrf,0,1,5,0,6
R_3oYmEKJeSweHyY2,9,1,0,0,10
R_1InGuVhaVGe9DTV,6,2,0,0,8
R_3MQEcmYW0nRnxNO,4,6,0,0,10
R_1f16mj9bHI9Oa6O,6,5,2,0,13
R_089Luuam6fPkOit,8,0,0,0,8
R_0lG4zQSRcdOH3fr,5,3,0,0,8
R_0p9xMoBvgh6ELOp,7,1,0,0,8
R_0pj9UKRl0T51sS5,6,2,0,0,8
R_0UMEgzbIgw0VrIB,6,1,0,0,7
R_10paHFFxIMtDQxb,7,1,0,0,8
R_10pIwwq2ppYZijD,6,1,0,0,7
R_10u4SwOHABZUwvE,8,2,0,0,10
R_11aUxS04Ye6mYt3,3,5,0,0,8
R_11YgMgOXoxltlLE,9,6,0,0,15
R_123AwJ7B9seyOhZ,7,0,0,0,7
R_1BQtYnM4nnvod5b,3,6,0,0,9
R_1BUTAh22Sj1q63y,6,4,0,0,10
R_1C0YWt3knxx8E3m,5,4,0,0,9
R_1CC8AiwomjYn5ZF,5,2,0,0,7
R_1cZVCMtWhbO74un,4,3,0,0,7
R_1ddiw9hpsnyPqF7,7,1,0,0,8
R_1dtx1Iuwf9EtFBv,4,3,0,0,7
R_1dukEbtcZCg4F1y,2,2,2,0,6
R_1EgHbmOKHW5GhtD,7,2,0,0,9
R_1f1tUlikj3MpqVi,5,3,0,0,8
R_1f42Xq1KTksDCFe,5,2,0,0,7
R_1f9o2N0Z5Z4sOFT,6,2,0,0,8
R_1FJ1iUnqvCEkKby,4,2,1,0,7
R_1FLB2HzFESE6dR8,6,0,2,0,8
R_1FyOMPl8yXbTM1S,3,4,0,0,7
R_1GDiV0vjigm7pCV,7,0,0,0,7
R_1GJFRh92kZhLiAy,3,2,3,0,8
R_1gtFus6zOEsd0fE,9,0,0,0,9
R_1H8nE0SFr1sB4Kd,2,7,2,0,11
R_1i40JBNkBobAekh,0,2,5,0,7
R_1ifXnAyOdq6WCUV,3,6,0,0,9
R_1IoMvS8lO1nbauG,7,3,0,0,10
R_1IXlcy3whG2dNHQ,5,5,2,0,12
R_1jIoVa6qxiEtPsn,5,5,0,0,10
R_1KkwcQGHfWxtYtK,7,3,0,0,10
R_1kMub6PnACB14yW,8,1,0,0,9
R_1lglVKlZztTPQ9V,5,0,0,0,5
R_1LZrLACKKIUaUey,0,6,4,0,10
R_1M58wAHG8KTKIv3,4,2,1,0,7
R_1MJRVe9uHBv7mr5,9,1,0,0,10
R_1MLOQt9shtnVElk,4,4,0,0,8
R_1MMAb3pHO0AMzz2,3,4,0,0,7
R_1mqjbB8Yyiee1yh,0,1,3,0,4
R_1msIT9rD3KrNU3H,7,2,0,0,9
R_1mzlZfrqdAkPrZ4,1,2,2,0,5
R_1n29BYW7CIEIF8o,8,0,0,0,8
R_1N5lUg5aokkgrO8,4,4,0,0,8
R_1NejzJPBLeKO62O,8,3,0,0,11
R_1NfR1Fk6pCHoBpg,6,3,0,0,9
R_1NgL4gsMB1DNpX1,3,2,0,0,5
R_1nNn4bIgmaIE7Ea,8,1,0,0,9
R_1oHXBMWIk6lMF9M,6,4,0,0,10
R_1OTCUK1jssT6IDj,4,6,0,0,10
R_1OTUY7VPSxEavTQ,4,7,1,0,12
R_1ovGitIeVEP4Qw0,0,4,3,0,7
R_1OxD8KpzrmENulR,9,2,0,0,11
R_1OZTb5Cl6RVrHij,8,0,0,0,8
R_1P7QsrVfM2fBYLY,5,1,0,0,6
R_1pMUW33ayjnQeXA,5,0,0,0,5
R_1PRYwjraTC5pqDr,6,3,0,0,9
R_1Qa11QSgXuVyV1K,3,4,0,0,7
R_1rO0VOybeP594jr,4,4,0,0,8
R_1SIGzGOazZmL6ud,7,2,0,0,9
R_1ZYzlK8pG8JRtwl,6,2,0,0,8
R_20STWbAWQc055iN,2,1,3,0,6
R_20Y93K3nl9q8qtE,1,2,5,0,8
R_21dEzjARFNaLml5,6,2,0,0,8
R_21jO2Zy8IstfkxK,8,0,0,0,8
R_22Qh99YV9aA8bdU,9,0,0,0,9
R_23fBIPt1UtSLkpK,4,7,0,0,11
R_23W6cIK0dyqwKjo,6,1,0,0,7
R_24CU25x45mhmaBc,6,2,0,0,8
R_24dXSqvYvC31qem,6,2,0,0,8
R_25RYt1zouetJqau,1,1,3,0,5
R_268ZPRPWyRNW7I5,8,0,0,0,8
R_27aiwG1eM0ic2Tp,6,5,0,0,11
R_27EFSN7TksbQduu,7,3,0,0,10
R_27k7plxg0WVYKuh,5,3,0,0,8
R_27s4p8Od7WR7BOF,6,2,1,0,9
R_27xIhEqKvTTMp3A,4,4,1,0,9
R_28Gay2joSNBAdaZ,3,4,1,0,8
R_29brgFs1mWZk9O3,5,5,0,0,10
R_29tYtEG7vdSrt5U,6,3,0,0,9
R_2AEE7YTzVIXxkyh,1,3,1,0,5
R_2ARoIP3XWyx43qP,1,3,4,0,8
R_2aylh1UfnHxq6vC,7,3,0,0,10
R_2BaFH7S1cWvui6T,6,1,0,0,7
R_2cbgjUXGjT7ntvN,7,0,0,0,7
R_2CTW5rEJSaNuXZS,6,3,0,0,9
R_2cw7f3eSPCIssgI,6,0,0,0,6
R_2dGs0VmnLA422L2,5,2,1,0,8
R_2EbBz1ec7qbxW5T,6,3,0,0,9
R_2EbocWFUWvyw9Wy,5,6,0,0,11
R_2EgHCQIS0n79jmW,5,4,0,0,9
R_2EsjGATtRj84dmZ,5,2,0,0,7
R_2f2rGpU6somnUEA,2,4,0,0,6
R_2fk9iju7bgRBR47,6,3,1,0,10
R_2OTlmyi1MRIcuLx,4,4,1,0,9
R_2PnxUxdaalXcDcs,7,3,0,0,10
R_2qaZHTmIoQo9HdJ,0,4,2,0,6
R_2QhwL5JJGXuk088,8,3,0,0,11
R_2qr4Gi5nc6kiLWs,7,2,0,0,9
R_2qxDjHgr5m3Xicm,7,2,1,0,10
R_2RX4syhadKN5SYx,1,1,7,0,9
R_2s1PrDzre6wLAlw,8,1,0,0,9
R_2SCXicpPcemihjf,6,4,1,0,11
R_2tExMxdz2FrT7Mz,4,3,0,0,7
R_2tG4VppX8s5ztEh,5,4,0,0,9
R_2tuulKGFFEcdDzl,4,5,0,0,9
R_2UbXxZYFEwxC8l8,4,6,0,0,10
R_2Ug5huheoxTiSE4,8,1,0,0,9
R_2V9m64u6ZitNfVz,7,3,0,0,10
R_2VaVYAedT9wI6Ae,5,3,0,0,8
R_2VBDbIwn9QldEWB,7,2,0,0,9
R_2VCSKjpmb5lhHVI,3,5,1,0,9
R_2VDB7kW3z2nTQIZ,4,4,0,0,8
R_2veOQHQocfRQMsJ,4,4,0,0,8
R_2VgcVQfdINEIwTi,4,2,0,0,6
R_2vY8fNAvFbMB373,1,3,2,0,6
R_2xIQyWuY1vuQaQt,1,2,3,0,6
R_2xWQB5XwHfl3esQ,3,3,0,0,6
R_2xz8LhEFxAM350E,6,2,0,0,8
R_2ydTeUuKUXRbKff,5,4,0,0,9
R_2yl5S7fulfZjUyA,7,0,0,0,7
R_2yqhv3XLlxdu1X2,2,4,3,0,9
R_2z8zZfmRMl0fWV4,6,4,0,0,10
R_2zbVB3IzfMuBvWe,3,7,0,0,10
R_2zjUzFDaEXaNoKE,3,2,0,0,5
R_2zl2zJIm3sYy0tI,8,2,0,0,10
R_2zSjabThzwo12dj,3,7,1,0,11
R_2ztMm2gBgMkaXco,9,0,0,0,9
R_2zYcnGmZlwuSSUB,5,5,0,0,10
R_2zYiXqkqWY3M9Iq,2,6,0,0,8
R_30cxHxSk5z8V27i,4,3,0,0,7
R_30e3bljNVumGmbx,5,2,0,0,7
R_30k6Endg6NkEbaq,6,3,1,0,10
R_31gYMLhV50rVZSf,4,4,0,0,8
R_31iokfk9RQ7quEH,3,6,0,0,9
R_31mduQjrNFkhGcG,4,5,0,0,9
R_31YrrCi2KO0trqi,4,3,0,0,7
R_32RfRe7udD86hd0,7,3,0,0,10
R_337IdDgsGQyk7Jc,7,8,0,0,15
R_38iJJT5695AAVUZ,1,1,0,0,2
R_3CNIAnqSAAVAiO0,3,4,0,0,7
R_3CPTjYECevadUMp,5,1,2,0,8
R_3D6zDj85vQ4A06p,2,5,3,0,10
R_3dPKfAShgP4eEuS,1,4,2,0,7
R_3DwrY0ir1tYvGJw,4,4,0,0,8
R_3dXKMUNhTNGYAmR,3,2,3,0,8
R_3EcWsB7vmAMinCL,7,0,0,0,7
R_3eeM3IgxbAhTFgj,6,3,0,0,9
R_3Em9gmf8PqMXywX,7,2,0,0,9
R_3EQBI2cWulvgshQ,4,3,0,0,7
R_3ERAXnaM02EP5Ml,5,3,1,0,9
R_3esfXftUav8tk8u,7,2,0,0,9
R_3EzJlKP3BnSpsRX,11,1,0,0,12
R_3fI4PghAjsunCL2,4,3,1,0,8
R_3FWpSV1uhtRcvP7,4,5,0,0,9
R_3G0sQ3mywbbxDWh,4,3,0,0,7
R_3G1EsaDYMKTOtUv,1,4,0,0,5
R_3g1u1Fl88uf4sUi,9,0,0,0,9
R_3g8flpGDCaqnQ05,5,1,0,0,6
R_3GfUKdRlBVWcWkf,5,5,0,0,10
R_3GoLFcAHcAgG7FT,7,1,0,0,8
R_3GozWv8dJLpXjub,7,2,0,0,9
R_3GycASg9pJYRBW0,7,0,0,0,7
R_3h6BbJMHu7OB0rS,2,7,0,0,9
R_3hb9vFfU7CtwPw8,6,4,0,0,10
R_3HCxRJTw0wOj3Eo,2,4,2,0,8
R_3HOBUTi0dIwYnId,8,1,0,0,9
R_3Hv5tnoh3b3FJs8,5,3,0,0,8
R_3HwdQyo3kxSsXuH,4,6,2,0,12
R_3I6K71ycBq0pytX,4,4,2,0,10
R_3I6U4UXxwcT6Ct2,1,6,2,0,9
R_3iVwm8S0QpX0Zmh,7,3,0,0,10
R_3j23cZKN2bLOwb1,1,2,5,0,8
R_3JIRTgT9AK0PGfb,7,1,0,0,8
R_3JJ0DyUiXl6Lvh4,9,1,0,0,10
R_3JztvfArDu7O7fB,4,3,0,0,7
R_3k1UpdOMBTB2gs7,8,1,0,0,9
R_3kh2KIXMI6n6DnO,4,3,3,0,10
R_3kvKsKNA2Jtlj2g,5,4,0,0,9
R_3kyXxd6eC8bNpam,3,4,1,0,8
R_3L0IbcslA33FQaV,1,6,1,0,8
R_3lEUvWyrIMaiVvA,4,2,1,0,7
R_3MARPefJTRXUxFo,4,2,0,0,6
R_3MEHBddUssGbvEm,4,5,1,0,10
R_3MPwRKpNyXWxE74,7,2,0,0,9
R_3MQfwlIjh7WHGq6,2,3,0,0,5
R_3MSRO6AIssS9fZB,7,2,0,0,9
R_3NEEyg6y7zTaBgC,5,1,2,0,8
R_3NIg2KoRInQ0eV3,4,4,2,0,10
R_3NKGQcmgGLzFpAj,6,3,0,0,9
R_3nSBSnvnyKD5TEU,4,3,0,0,7
R_3Oe9y3Liq8TqUNr,3,2,4,0,9
R_3OfCuFxwSPTfHyy,3,4,2,0,9
R_3oHBHobGTEDNNPP,5,0,1,0,6
R_3OoaqNTS5KnmyrY,4,3,1,0,8
R_3OrnFJKTh7M8QXT,6,1,0,0,7
R_3P50PDzYkCgep5I,6,0,0,0,6
R_3pbeMWFRsNltMER,2,3,0,1,6
R_3pfYX1mTeIqvzgr,4,5,0,0,9
R_3Pot2StgNcQzFoF,1,5,2,0,8
R_3q8mWZbBpgnPFAd,6,3,0,0,9
R_3QMECjTpBaHpWlE,7,1,0,0,8
R_3QmxhXclLeSZSM1,4,1,0,0,5
R_3QPJLRSgOBqN60r,8,2,0,0,10
R_3qyxnvbbeL6qJzY,10,0,0,0,10
R_3R1NxuOQkXx3ph8,4,4,0,0,8
R_3R26xgRh2SCqb1y,5,3,0,0,8
R_3R44VVaBti5ADrr,8,1,0,0,9
R_3rIqwDzMrHCW9d1,6,2,0,0,8
R_3rNSgdh2oAQOZt9,6,1,0,0,7
R_3rP4ya6S9k8KloT,8,0,0,0,8
R_3RxaccXuAs8dOrE,7,1,0,0,8
R_3rYsbj9KrT9ZlzU,4,4,1,0,9
R_3s0VHWEg518QCX7,2,4,0,0,6
R_3saa8AJkyb6kEuJ,7,0,1,0,8
R_3suWbetnbfTtE6T,4,6,0,0,10
R_40gPF5PFYWf3oVH,5,4,1,0,10
R_5mYuNBY5DPPtXXj,3,6,2,0,11
R_5sZDA1NvHovVZ8B,4,4,0,0,8
R_5yws4PjI2GRwByh,6,3,0,0,9
R_79TNIkdNTMphZOp,4,3,0,0,7
R_9phsTBBTFqnuIrT,7,3,0,0,10
R_abM2iFQ8DkK9qtH,7,1,1,0,9
R_agiB29HmfFYAlVf,9,0,0,0,9
R_AI1Y6VpRC8Rcm8V,3,3,1,0,7
R_beo3LVbaJVFpYYh,1,4,4,0,9
R_bl2G6q6BeiVtJ9D,3,4,1,0,8
R_BrhFtV7hwjru8ed,7,2,0,0,9
R_BSs1byod0TgOzZf,4,3,1,0,8
R_CgyH2UH9YfHdLnX,7,2,0,0,9
R_cXTkeqnUzDtgUut,6,5,0,0,11
R_D1U5I025evQaLaV,6,1,0,0,7
R_d5pjoMzPw1fQemR,8,1,0,0,9
R_D7b8MmI5E8jrhCx,7,0,0,0,7
R_e2kmfBCHnhgJxxT,4,1,2,0,7
R_pgdDhBfWK83mTrb,2,3,2,0,7
R_phjLrOaoSP1gZMJ,6,2,0,0,8
R_pQwgODTIICWsXap,5,2,0,0,7
R_psk3NrrncD9Q9YR,8,1,0,0,9
R_puENX463xlPdJAt,4,3,0,0,7
R_Q50IvwT8sDL9pWV,9,1,0,0,10
R_r0v51Tb3dPq4Ynf,3,5,0,0,8
R_rcJsCs9Lk3aMSOZ,5,3,2,0,10
R_RCWNlQhAubejwDn,5,1,0,0,6
R_riHV4fbDmM96449,11,2,0,0,13
R_Rq3MuiiwuPu8xOh,5,3,1,0,9
R_RQcdLDzI6jJyWf7,5,5,0,0,10
R_RRIchswRw9cNkTT,3,6,0,0,9
R_Rzs4Wa25uD5OXf3,7,2,0,0,9
R_sBS1Os1nlONU4r7,8,1,0,0,9
R_sMsoBoMKlxPrsqZ,6,1,0,0,7
R_smVL6ZvRHejMRCV,6,2,0,0,8
R_sMWB93dbLi0jAit,4,7,0,0,11
R_sT2RwGmX6M6HlkZ,5,2,0,0,7
R_TpFR2kRmoSd331L,0,3,1,0,4
R_UEMyUlTJLuTYd4R,4,2,0,0,6
R_UFIOXmRvZjaBcuB,1,9,1,0,11
R_UFTnywafm4Rtj9f,1,5,1,0,7
R_Uz12zCOjC0iRjI5,4,4,2,0,10
R_vc9O0KNmWejfByF,9,0,0,0,9
R_vdZNduTtxclmbCN,5,3,0,0,8
R_vPn6paV7EQv0TM5,5,4,0,0,9
R_vud50AiToeendT3,5,4,0,0,9
R_WcBumyInvjtiArT,5,3,2,0,10
R_xFWt4WxlYbNL46R,2,5,0,0,7
R_Xj3lCJObwCQSwrn,2,1,5,0,8
R_xsgP7JRGfdVDIhH,2,5,2,0,9
R_Xw6aYUAkimiqY5X,4,4,0,0,8
R_Y5DFS2RCfVwTd5v,5,2,0,0,7
R_YPn2lzLM8l6kGUp,2,2,3,0,7
R_yszjuuuB084bPKp,8,0,0,0,8
R_YWw4n4J3f5yQPv3,6,5,0,0,11
R_YYQNuDZFUfn3WPT,7,3,0,0,10
R_z6kku53yk9nzwYN,2,5,2,0,9
R_Ze5gNwhRV6WsTwl,6,1,0,0,7
R_Zfav1BmSbxnUXdf,2,1,5,0,8
R_ZIfnV99tIbdmqUV,4,6,1,0,11
R_ZKnCpTsvzwGeVS9,5,2,0,0,7
R_2xVPcoKkOMJZ4hx,4,5,0,0,9
R_ZeQ0eBSv6WuJ4Wt,9,0,0,0,9
R_sedNEpnTKX33oT7,4,3,1,0,8
R_V1DF15bRa7WgUOR,6,4,0,0,10
R_3iRaqtz3uhQYAwD,2,7,0,0,9
R_31MKBa763Hsr7zY,6,4,0,0,10
R_1rlwjMcqpvSqcR3,5,3,0,0,8
R_Ze0G7t2XkbrQA6Z,7,0,1,0,8
R_3DkkMMB8Q8VK0rS,4,4,0,0,8
R_1gw01qnL8P19O5b,4,2,5,0,11
R_ABvDYpVURyMKdnr,5,4,0,0,9
R_9XKddQrtYZly21b,9,1,0,1,11
R_2Yo0oYlwB1fwbH9,6,5,2,0,13
R_em1NCL32PImOvol,5,3,1,0,9
R_3qPuwxaSfIbxw64,9,0,0,0,9
R_OHFrakCZEpTsVvr,8,5,2,0,15
R_eA8G6ViooOlI2Ih,4,3,3,0,10
R_3Hp42XmN493YQKI,4,2,0,0,6
R_2CDq8Xlf71LBJoO,5,0,0,0,5
R_1C48IkFa1aRgPG8,9,2,0,0,11
R_29hOQcntnbJotnb,10,0,0,0,10
R_22oatNmzdtWmP0K,3,3,2,0,8
R_3Htv3ucQv6gUTiu,5,5,0,0,10
R_2wMJRNYDz6Bv5Ka,8,3,0,0,11
R_2y2UvPVhDgPy3u7,4,6,0,0,10
R_2xWfIPMjbpN1Cnz,4,5,0,0,9
R_1rGheBvXSHArStY,4,4,2,0,10
R_tWdVOsh4r8YzIKR,8,2,0,0,10
R_XRFgst1yAsiXiXn,8,0,0,0,8
R_2v2C9lzMU7oj9MJ,7,4,0,0,11
R_1OluGeKnJStuubV,5,6,0,0,11
R_26h80dxig5LIM0f,6,3,0,0,9
R_2TSH9hQNuYiI6es,6,2,0,0,8
R_3J5ezQcc9jIkqIY,5,4,0,0,9
R_2WCicKAHoNa3KAB,4,4,0,0,8
R_3iI1RHKSm3NhPvk,10,0,0,0,10
R_2abGj1sqSpX1f8V,4,6,0,0,10
R_1g6AOx6KcE8VkZi,6,1,2,0,9
R_338bl330FTzJE1B,5,0,0,0,5
R_O1kLUI0aWY1chLr,3,4,0,0,7
R_31ZT3AUuB7E6AJC,6,4,0,0,10
R_3sB83H4H7NTrKuZ,4,4,1,0,9
R_1mt3mA17j6rnGYw,9,0,0,0,9
R_ClxwLS2DzlxSUPT,2,3,5,0,10
R_3MakXs4nk3sGmvA,6,4,0,0,10
R_3EGVuF1EnxEqwI5,8,1,0,0,9
R_8xj0nSPphO27mQp,6,3,1,0,10
R_2WAP9qcPXkcQ05B,6,4,0,0,10
R_2S7TH3cRa28XiFh,3,5,0,0,8
R_6gotxWl2bWKF55f,8,1,0,0,9
R_2S2g7ORotzrJymT,7,2,1,0,10
R_2YXutbFYJGq4zAR,3,8,0,0,11
R_2AHhfp8pVCBygJ7,0,6,2,0,8
R_3k1WSlaTZ3ETZyl,9,0,0,0,9
R_264RF10ExmglXwy,4,4,0,0,8
R_XyNskELnvjDm2Ep,7,2,0,0,9
R_Z7s94eQt5A6I3FT,3,3,2,0,8
R_30wPoctjsBA3sGr,6,4,0,0,10
R_ZmHlCnOXroRrYUV,6,2,2,0,10
R_2wv3D3yaISgSqF3,9,0,0,0,9
R_QhlGRtMLNlnFlEB,5,5,1,0,11
R_2DN46aPpXKP7LWZ,6,4,0,0,10
R_3DhW7ZlyXK6Vzcv,1,3,0,0,4
R_2ygBR3N4gbcWUTm,5,3,0,0,8
R_2V3JJGdLqsaPWyQ,5,4,0,0,9
R_1ONeZf0E4iO0uFu,7,1,0,0,8
R_3M063Z6sCVwLUrY,4,3,0,0,7
R_3HtsABmgJEBDUMO,0,4,6,0,10
R_2rjbzxllW9jK5HK,6,2,0,0,8
R_PZKmRia5MFzhetH,8,2,0,0,10
R_1FfkpS4Lx5nKHpU,8,1,0,0,9
R_4SIqXmnzkv3BaDL,5,3,1,0,9
R_3D7KPAPASKyJ57L,4,3,1,0,8
R_24hKu3KoTFK1Jg6,4,5,1,0,10
R_PzZyp6XWgk4MYSJ,4,6,0,0,10
R_R8ZBxbyATAAXAKl,3,6,0,0,9
R_3jTXdOatsff2WrV,10,1,0,0,11
R_eSb8UbS98Ly1WAp,7,2,1,0,10
R_2aVPQ8n0ggISKnH,4,5,1,0,10
R_3kt5x34MqpRk8Wo,9,1,0,0,10
R_2E6NV0NptzkXy9E,7,3,0,0,10
R_24l5X4ovpRi9b9H,5,5,0,0,10
R_216qOpN6AOUYg2M,6,3,0,0,9
R_11crRhmuidkOLbZ,0,4,1,0,5
R_28CJFuzsGp20pXC,0,7,2,0,9
R_3DwhxuBPc96n7eL,8,2,0,0,10
R_1Nst5MCX2eVdof3,9,2,0,0,11
R_BJkoFpGYZGYZ12p,7,4,0,0,11
R_4U7O5PPEMeoyQox,7,2,0,0,9
R_1LB58qA7rtyy2OS,4,4,1,0,9
R_8wujcqrMufr00pj,4,5,0,0,9
R_3kM2fY6TwfnBWif,1,6,1,0,8
R_ZDYIZRx452MdarD,10,0,0,0,10
R_31QNFmQRco1IuD8,5,3,0,0,8
R_3PCfmXBEqhxGSFQ,9,1,0,0,10
R_1r0P1EXxF5C4Qcr,0,5,0,0,5
R_7WkTcnQ4mOJrBYt,5,2,0,0,7
R_z7N8aiLLmn7SMjT,8,1,0,0,9
R_yOMGrFQqG101USB,0,2,7,0,9
R_21cgma3RmiWOM2v,7,3,0,0,10
R_AMpHvuKw79nG0vL,2,5,3,0,10
R_r1ghwL0RAX7IdRT,7,2,0,0,9
R_bKKTYxZ8kPLKbpn,7,3,0,0,10
R_2X0eTczEPUri9CI,7,3,0,0,10
R_1qVWJaP7P3P0GQ4,11,1,0,0,12
R_1Do0e6c4sD8Xezs,3,6,0,0,9
R_blyvQ7e4OmCuRCV,4,4,2,0,10
R_2Yn1ZKvqf1o9xxQ,9,1,1,0,11
R_3mfPdBhbNIEt3aR,1,2,4,0,7
R_Y9umQ9j9kqkMtZT,3,6,0,0,9
R_PzliNHRUQQTpzvX,9,1,0,0,10
R_2wKSG8qpTv6CooV,3,8,2,0,13
R_9uZS1cLOmNAHqIp,0,4,3,0,7
R_2ZUrnlqAGserfsD,7,3,0,0,10
R_3fcQepKxdyVqzZc,7,2,0,0,9
R_2VlijZxJow8nFu3,5,5,0,0,10
R_sBYAu7Ifn2DxP9f,7,1,2,0,10
R_1Q5Y8Uhn0CYVqtl,5,4,0,0,9
R_25zR3IYmAZlCXUC,5,6,0,0,11
R_1jZENTMN8aApzV0,3,1,3,0,7
R_PwHXWyfWxxEJAUp,8,2,0,0,10
R_1GHxdYanls2wY0k,7,2,0,0,9
R_3MzN28fuTGmS92x,5,4,0,0,9
R_DuGmPFvGczblxdv,2,3,1,0,6
R_3qQeMBs2CFDnTQa,9,4,1,0,14
R_06eKent30d1ptIJ,6,3,0,0,9
R_3hfnvU9nruqVNFx,5,6,0,0,11
R_PAjXi7VJdaJoNxv,6,3,0,0,9
R_21bIayBCXgieqvz,6,4,0,0,10
R_2fxtcdYF2sMZ3Bc,5,3,1,0,9
R_1rDLzrai0KXURNn,7,2,0,0,9
R_AGWbgLdlJ8mWbZL,2,4,3,0,9
R_3shUpDmnOVdAxMR,8,2,0,0,10
R_2awX4Y4YOftd23T,3,5,0,0,8
R_RrGGZXyX9uX6rPH,8,3,0,0,11
R_3FRSisNSu3wwfyD,7,4,0,0,11
R_2BflexdTgyiHnQm,4,4,1,0,9
R_1puiYybdFQYgk8g,8,1,0,0,9
R_2yqnQdgDWmeMTxA,9,1,0,0,10
R_WCX8Ei7msc8sgtb,6,4,0,0,10
R_Y9LtKXa1byKgUdb,0,6,4,0,10
R_XnyDjAq4XQsT3FL,8,2,0,0,10
R_3FV5dUuwrrc164Y,5,7,0,0,12
R_3ObMH5TGRf1NykF,2,4,0,0,6
R_rdrj0tviIo5ykbT,3,2,3,0,8
R_2Qohd6ZdQhToNTC,8,2,0,0,10
R_32L3rbgfILVvaKy,7,4,1,0,12
R_3NCXOhTNa7w5lf3,4,5,1,0,10
R_2VJDMCBcBKH1lRP,3,1,1,0,5
R_vMOq5sRJ87JoePL,1,6,2,0,9
R_2ruTpgCxpjGPQS0,9,1,0,0,10
R_26nIciIVbPQiQhg,3,8,0,0,11
R_8ddE7YgOnLcTIAx,6,0,1,0,7
R_2QPuoAjUCVL9VMa,0,3,6,0,9
R_2vYqPSatIqJg8OB,7,2,0,0,9
R_Dd8rJGP3GrOUpJD,2,5,1,0,8
R_3LZof9vO8DB8JhV,4,4,0,1,9
R_QhbwVQKkfzNBaVP,8,1,0,0,9
R_3oZSS5FrLVOm0mt,6,2,0,0,8
R_3PiP1NRj7INf8ok,6,4,0,0,10
R_2WPcHcpIdcK7P5Q,0,6,2,0,8
R_12uv4Nex7laLB34,7,3,0,0,10
R_214UWXQ4by5ifTa,7,3,0,0,10
R_3KosYrqXQLPvSoL,6,2,0,0,8
R_2CKE7hTfNrEnTjx,7,3,0,0,10
R_1lzphaulzQsyY4t,8,0,0,0,8
R_2QyOVQg47LTihWi,7,3,0,0,10
R_oXcGPRguleD1zZT,3,4,1,0,8
R_D8HiFh7kjyObR5v,5,4,1,0,10
R_3en7cwSitwOxwdJ,5,4,0,0,9
R_1kLVdyJSGFhqT7u,6,4,0,0,10
R_ZIa7lljNeg1L0sh,4,6,0,0,10
R_vqyRsua7AqNf7uV,1,1,7,0,9
R_3fAZpzUzM6mKwqG,2,6,1,0,9
R_3D6COU5x7AD5HWo,6,2,0,0,8
R_C7f9P4pREOCt1Id,4,5,0,0,9
R_3iwHs3ghmazrWBI,8,2,0,0,10
R_qWxsERPeqLSZf0t,7,3,1,0,11
R_6GqHR2zhDvemg6J,8,1,0,0,9
R_1DLUH1Jst6XxEoD,4,5,0,0,9
R_1MKiibnjY1z90Pt,9,3,0,0,12
R_3Mfh3IFMU5lZyU9,5,4,1,0,10
R_2VK3J1i4slooAPV,5,3,0,0,8
R_wQViQabQFifPVdf,4,3,1,0,8
R_2ZVmdUEaFSU4j3Y,6,5,0,0,11
R_11d43Hvpl3EG7ZQ,4,3,4,0,11
R_soPdw1LZbuu85pL,0,3,5,0,8
R_1o5zHgHbFbK50Nb,6,1,1,0,8
R_2dzNl4CL6bdYNnQ,5,4,0,0,9
R_Ucp9usVPYyoYJsl,6,2,2,0,10
R_2Sowr4FMWMtNvfI,7,2,0,0,9
R_xGkOx2JXX9ezwVX,8,2,0,0,10
R_2EAKp5ooHhTS5j4,6,0,0,0,6
R_1irK4B8YYHSgCNA,3,6,0,0,9
R_ZHQVN5nO3OqGr97,7,2,1,0,10
R_3JJFPlrDdA90Xcb,7,2,0,0,9
R_27OMOhRRNI1a2Zz,8,2,0,0,10
R_3JL88lcaCYPNb5F,9,0,0,0,9
R_VX8Om4mAYrkcBP3,8,1,0,0,9
R_1irCy4OMKjiMnbP,5,3,0,0,8
R_1igjjIrgBr4uqjq,8,2,0,0,10
R_3MuJj6Y25cXpDna,6,3,0,0,9
R_Qfw9ET7UxYPeXx7,5,5,0,0,10
R_1TtTbeKVAZlfqSZ,5,4,1,0,10
R_1dgFAARVHnyJq8l,4,5,0,0,9
R_qKFzlxBxnyQ679n,5,3,1,0,9
R_3HSPT2bvgGEdZzq,8,1,0,0,9
R_1P0JNxnTlfFjiDc,8,3,0,0,11
R_25ZPbozGlAw9C3L,7,3,0,0,10
R_3nk1FtTN20W4oyf,5,6,0,0,11
R_3knxbAmwlJafze7,0,4,4,0,8
R_3iqjl5cgRwzy1D2,6,4,0,0,10
R_WuRxMkxflD4E521,7,2,0,0,9
R_3PALgJHOifrdrzY,6,3,0,0,9
R_3oMGnG5MSpwbYvZ,5,4,0,0,9
R_1jD4GwKdB6AsMYw,7,2,1,0,10
R_30c025lX7UUqjWZ,6,4,0,0,10
R_3ql39UJpCY7hKKo,2,6,0,0,8
R_0fh9oyjGjZamCAh,6,2,1,0,9
R_3Ea305Ye3QI958A,4,3,0,0,7
R_3jSsAeB812cvSLw,2,7,0,0,9
R_3maDijx9pn5xoDV,4,1,3,0,8
R_1Gy1qTzJwQ8g97j,5,4,0,0,9
R_We5WcF5OLetuMAp,5,3,1,0,9
R_SVLjAl34F1SdN6x,7,1,0,0,8
R_31tNLn2uOUC8zPN,7,4,0,0,11
R_3HzXnJy3XFrXwhW,3,6,0,0,9
R_1DAq0fCgwUhwGZo,5,2,2,0,9
R_2Cg1qDdzT3XI12o,6,3,0,0,9
R_1ojzA9hS7OGSfXZ,5,4,3,0,12
R_vuY7rkcukGqYByx,9,0,0,0,9
R_1HcQ6j7VNLtCImX,6,4,0,0,10
R_4PgW3CqClxD0nzb,5,3,0,0,8
R_3Raubx0mkT0EnYs,5,5,0,0,10
R_8vNIzEc5lXVvZTP,10,0,0,0,10
R_3Gvtk5MxGb3lPiJ,9,1,0,0,10
R_5uQ4Dwd3ZcQ2XgR,7,2,0,0,9
R_3KC2GkiJrlCU1Fq,5,5,0,0,10
R_2QfYNSwAoqnsSz4,5,6,0,0,11
R_2xDmRFElp9FA5Qk,2,4,3,0,9
R_1eK2cjEbuuaDF6g,4,5,0,0,9
R_2tM5WfrCZ6CuZQ9,8,2,0,0,10
R_3kw6yiLexSrkuZP,6,2,0,0,8
R_6kZVyvvWbR9Pe8N,8,1,0,0,9
R_BPLCF9K2RYsQH7P,4,2,0,0,6
R_PIh3Kiel7SMVMB3,1,4,4,0,9
R_3IZh2470cUsKcT6,7,3,0,0,10
R_5C1B6bpJvZDaqCl,7,4,0,0,11
R_1BR7jjIpCKqejEh,1,5,1,0,7
R_2fJK3cJEuGGwLX3,8,2,0,0,10
R_1K0ScFmT7Pyr9CT,0,3,3,0,6
R_0ky2GbpTVZPIQff,5,3,0,0,8
R_3hEDqXTT1mqdMBs,4,4,0,0,8
R_3t6tC8s30pvjfDb,1,0,7,0,8
R_3D7qfxszBTKAn1X,2,8,0,0,10
R_3g629u2k8F9igld,9,1,0,0,10
R_3m3R61WSC4C8hsE,7,3,0,0,10
R_1puj4DsI57th9qY,1,4,4,0,9
R_3JDvelkHzRhv7aZ,7,1,0,0,8
R_vv7kRBlt1Y6V4Dn,5,4,0,0,9
R_3nJ04cutVS5q8qd,1,9,0,0,10
R_3jcjUXIX9WLsPbJ,7,4,0,0,11
R_1fkCXUq0khQSoVW,10,2,0,0,12
R_1d7cfs1uF0Z6n0w,5,3,0,0,8
R_xisU5BUEeuogkmd,10,0,0,0,10
R_3KAs4wM3B5bNpMo,4,5,1,0,10
R_1nTRe2DaYcgcoSY,6,0,0,0,6
R_2CVzAfAaHvCvTRN,10,0,0,0,10
R_1RGW8ZHYM3bnUwV,8,1,0,0,9
R_1IrNyZbtLT1C5N9,6,3,0,0,9
R_1gBmA4RxtUvpd4U,6,3,1,0,10
R_rpEByTx5uH9Qejf,6,3,0,0,9
R_eJRpAitKn9raj4J,6,5,0,0,11
R_2TS0IQ6eOktdP3Q,3,6,0,0,9
R_5ifLiU0Jdky7IaJ,8,4,0,0,12
R_2tcdmgKPA2UVGWI,9,1,0,0,10
R_tW2u3jn4LILqAal,3,4,3,0,10
R_2ymEdf9fsBBYvsz,5,5,0,0,10
R_27He2ZdZFOFL43r,7,3,0,0,10
R_3NVOeRzPWylemQL,4,4,1,0,9
R_1DwKNh576OceZmt,9,6,0,0,15
R_1OCA9phLpQEP7WR,6,4,0,0,10
R_239sYxI8G3kPwcQ,4,6,0,0,10
R_2AQdOQEG4zuh17X,2,4,2,0,8
R_3nIAgbJyy8aQLfQ,6,4,0,0,10
R_xFn0dEn1MtbRMIx,5,4,0,0,9
R_1OqtpZmo6efZBHq,8,4,0,0,12
R_2RV3w7x5r291i9Z,7,2,0,0,9
R_2qC3CeX4e5En27j,8,2,0,0,10
R_Qfvts96rYhdQ2wp,7,3,0,0,10
R_3p8ZkZiOsJn4Vei,4,5,0,0,9
R_2XcHwUu8oBkMBtT,7,2,0,0,9
R_1DNNMHmXw36M90v,8,1,0,0,9
R_vv2tIEDPKoBcwNz,5,4,0,0,9
R_115EoZ62xtaRZ5m,5,3,0,0,8
R_6ikAgtOAhiI1Pkl,5,4,0,0,9
R_u21tulyEOisZXmp,5,2,0,0,7
R_1duCnPx8gCgviot,4,4,1,0,9
R_0J4DrlosSwBtZrb,5,4,0,0,9
R_vrwz1bKTEFFSZy1,6,4,0,0,10
R_2OOt9mZhlHegC2J,4,5,0,0,9
R_2aQuTecyH1w0Abv,7,1,0,0,8
R_1Lzh2Kzm7WVP1so,3,6,0,0,9
R_3Gf9C1HzDoYCLRb,6,2,0,0,8
R_28GQJuaKLR25pFr,6,2,1,0,9
R_1H8qcpr8K2Tquo3,9,0,0,0,9
R_2zFHbkqM5InP7Bu,2,4,0,0,6
R_1BR89sGZ3a3eSlX,6,4,0,0,10
R_BPurIyBz0VJRrqN,10,0,0,0,10
R_3pi1REEhN9IZX9B,6,4,0,0,10
R_2EgGYSrow6ldcbF,8,1,0,0,9
R_3htClp45aPcwX93,5,2,0,0,7
R_12tApUcI25XTqor,3,3,4,0,10
R_3P6lVjlUNlPw1Fu,4,2,1,0,7
R_1hT2spvlvEngn0i,5,5,0,0,10
R_27a75lZhEpFwvFY,3,5,2,0,10
R_1QoTbfDH4a9Do8G,8,1,0,0,9
R_2PtfDyv2D5ibPje,9,2,0,0,11
R_2ru1vwqmts7dpAK,3,7,0,0,10
R_3O2LG42Qw6nOgtv,5,3,0,0,8
R_24vECrL1DKfTXNR,7,3,0,0,10
R_UcplodnRwbhF0zf,6,4,0,0,10
R_11jaEXmCybPvgpG,4,5,0,0,9
R_QcrMAePbCQtZQxX,4,5,1,0,10
R_p4dI9HHZXewGLzb,6,4,0,0,10
R_1DAvey4tyvyGkAq,7,4,0,0,11
R_2n5HjjtGprH40RH,7,2,0,0,9
R_3Hzca2sh9sJ4lp2,7,3,0,0,10
R_1EgFUrS2njdK6ET,4,3,1,0,8
R_ZDWY7FvxKQLk3vj,7,3,0,0,10
R_PZ3IKaQfaNA6IZb,3,6,0,0,9
R_31BNlEZ5I3F2eGL,8,3,0,0,11
R_3NVC9N3KeSHLj3s,3,5,2,0,10
R_2QSRyhTMBK9V45g,6,3,0,0,9
R_OBtsi3x3Mgj5WVP,3,5,1,0,9
R_pxF7qRqEjqlMgIV,3,0,0,0,3
R_123UQ6f2vPaCeEg,4,4,1,0,9
R_2CHObNIJACriwiA,3,5,1,0,9
R_tQzycNwvkEGo3ct,6,4,0,0,10
R_1FhRKSnD6P8EF7C,6,3,0,0,9
R_bdQ0sW8CQHCI37j,8,1,1,0,10
R_3qmNF43vmco4T0Z,5,5,0,0,10
R_2Eb0QOpqExMnV1z,6,3,0,0,9
R_6FnPkodzGKhlnuF,8,5,0,0,13
R_2BamK41PO8S7a8Z,8,0,0,0,8
R_3PLxaTf0xcHynoa,10,0,0,0,10
R_1OlUIGh2jVLayBi,7,3,0,0,10
R_2QyCkQ4J43McI1y,5,4,1,0,10
R_T6CELD161XeQR21,6,4,0,0,10
R_21nzpBFKvGXjokg,5,1,0,0,6
R_1gSXUg1EXn12vrj,5,3,1,0,9
R_2rMgueJmdi0HdDL,6,3,0,0,9
R_1NhmqA9EIVKWN8I,1,3,2,0,6
R_2zx7xy1KbgAMEHc,1,2,1,0,4
R_PzgMnGFXPgzo6Yx,4,4,0,0,8
R_2EAe5tNpw4OR8WA,8,1,1,0,10
R_2Xb8FtJNzAor7FI,5,6,0,0,11
R_2TWNdvAuD5RoyYw,5,2,1,0,8
R_cw2Wc6jt2zE9ail,7,4,0,0,11
R_1eRk7QkYkghEDRX,6,4,0,0,10
R_1K3GAptjQrrggiu,6,3,0,0,9
R_2t5yDqKae0YVFVM,5,5,0,0,10
R_1okh41y5mTxRdeQ,4,5,0,0,9
R_3Xb5JvedNuE5RlL,2,7,1,0,10
R_UxplCVnATCXsgmd,3,4,0,0,7
R_1CHLe9RFGZ1zfw0,4,2,0,0,6
R_2v3b39kt0kD7qwl,5,3,0,0,8
R_2903J2vyE2GuNM4,9,1,0,0,10
R_3fH814ZtIp1zt5V,5,5,0,0,10
R_28VhmoQnlkANQ8o,4,4,2,0,10
R_2Su8zVSgtkpSyiH,7,0,0,0,7
R_3NWWjlqFBVW0PUI,4,5,1,0,10
R_2wt24VJg8CQlMyB,7,2,1,0,10
R_3kJ4aeKr9saeHT3,5,4,0,0,9
R_XsONXWLDMy5kE3D,10,0,0,0,10
R_11XQQBrVyF0mtdT,5,4,0,0,9
R_2b2icDC25rjLYjW,6,3,0,0,9
R_1pu2ZNk8VpUd2Vc,6,3,0,0,9
R_3MQKgi3Z4ZANAo9,5,5,0,0,10
R_12MirEgs6gTIXR2,7,2,1,0,10
R_22sNJcRqXxWJrxH,5,5,0,0,10
R_x3qGjjLfwqUf7kR,7,1,1,0,9
R_5dz79tGnAksZ625,4,5,1,0,10
R_2BrlTT6Z4i5U0hI,3,5,0,0,8
R_2YS9GkpERztCQ5N,9,1,0,0,10
R_4Pl2duHszCAv5W9,2,5,1,0,8
R_3fxjZRFiguOuhte,6,3,0,0,9
R_9vNy3h9q2Fu9I7n,9,0,0,0,9
R_2BtkUB1cUKAKIfz,9,1,0,0,10
R_0qS03b6VYO92kTf,3,5,1,0,9
R_2EgUrLgfUZCTVcp,4,3,2,0,9
R_1nUCKDxlIDZP3d8,7,4,0,0,11
R_1o6gr0QMvhTDkup,3,5,2,0,10
R_SIbvP0m7hoMOW9H,3,1,0,0,4
R_3JCoyMn90yDdBOy,3,3,2,0,8
R_33eagcMEpJJs8lX,6,3,0,0,9
R_3ENkrzHFVqbwZY3,9,2,0,0,11
R_Qnudmbqz4bnNi4F,5,3,2,0,10
R_1LzZ92XM0QGm0Ui,5,5,0,0,10
R_115PsjTlU7v7T2V,5,3,0,0,8
R_22J5Co6eJIy0UH9,0,7,3,0,10
R_3L7MUTTsRZ6ZUKU,8,2,0,0,10
R_2QxpQsSnkLBZI47,6,3,0,0,9
R_1Q9DN7IngOhLXVS,7,3,0,0,10
R_3Q0ffCq4Js4kOmy,7,2,0,0,9
R_1M6T9iRPK5O1bFc,7,3,0,0,10
R_3qrEShNGDGQ9pyH,8,1,0,0,9
R_2wadBZ0p1Ui05zf,7,3,0,0,10
R_2gJy7yvZJewu0dX,5,2,0,0,7
R_3RrMCwkBOcvqDWR,5,4,0,0,9
R_2t5RAQl9vZJU7Pl,7,1,0,0,8
R_2YGw7g8IoAUyhn2,6,3,0,0,9
R_1hR33UEpNV8yCKR,7,2,0,0,9
R_1Clt8l9jR4NSm1K,7,3,0,0,10
R_BYs6ugajwIjvhAZ,5,5,0,0,10
R_302lKYZHtZRBeoR,8,2,0,0,10
R_3rNY33vDZ2N68bW,2,1,6,0,9
R_2Vmwv5VDlgLlySY,6,4,0,0,10
R_25uyEmL7pM6lOwa,6,4,0,0,10
R_2t35Zn5jr4ihPUA,7,2,0,0,9
R_SJYEW7rBysaLWVj,8,2,0,0,10
R_1IK06VyVzy0UVKB,5,4,2,0,11
R_2YbnpyPOPxd8kBf,5,4,0,0,9
R_1Eb8REX20wbiVa5,5,5,0,0,10
R_2wpLOtVKsIV8wMX,2,5,2,0,9
R_2cbUwjGaxvs1SMD,7,1,0,0,8
R_3OdY6Mza2cpARsT,5,5,0,0,10
R_UXyro6OWObivSyl,7,5,0,0,12
R_UFLKDoFMLa3aWOd,7,3,0,0,10
R_eDoQnE2FRZhE6L7,7,2,0,0,9
R_215kF7cvC2THdGb,7,3,0,0,10
R_1gbFnTXfLZYY5vt,6,1,0,0,7
R_1OhNiLtudDx2Emt,5,3,0,0,8
R_sRmirujENd6lsvD,7,1,0,0,8
R_DMMiz06W1bp2o2R,6,2,1,0,9
R_1GwqRr15ueNpTWK,9,1,0,0,10
R_yqKMjVlJxBh3ixj,8,2,0,0,10
R_s5K9VkyhLjpFDzP,6,4,0,0,10
R_3QFOB51CIzBP1SS,10,0,0,0,10
R_1CqB0C7i1Mwu4iA,5,2,2,0,9
R_3hEbYIdkYwhGBf3,8,2,0,0,10
R_OPZsNOp4sSGvNIt,5,5,0,0,10
R_2doRz8hTE42ffKX,7,4,0,0,11
R_2wdDFdfoSuonEaa,5,4,0,0,9
R_2AG7xsvVZlTQ6J3,4,6,0,0,10
R_3is66NRxcs6NKOb,4,5,0,0,9
R_UmvIYwZS8jPnm49,4,3,0,0,7
R_qIY4K55fQXVZ9ex,7,2,0,0,9
R_Cl7nIDTv5IcJfeV,9,0,0,0,9
R_3R4qVdMMtauzLqx,6,3,0,0,9
R_1kIkZpZt1iwfudh,1,3,3,0,7
R_1OIAtorJR0OmO0P,5,2,0,0,7
R_2Bg7B1CLxJ3JU3k,5,3,0,0,8
R_T60eRwQmR7sNBhD,9,0,0,0,9
R_3J4UY7FISj48313,7,3,0,0,10
R_1Cr98O8md20OS43,7,2,0,0,9
R_2cpjAZCSLSYj2Yw,3,5,0,0,8
R_2ONk6MBxcHGG7Bs,6,5,3,0,14
R_3PmutEdSeauRabD,9,0,0,0,9
R_2qyikGOpnsuG7Bz,8,3,0,0,11
R_2RV4ROsVeGkO6XL,6,4,1,0,11
R_elIHnwzjLmzsR3j,4,7,0,0,11
R_3ReHE1KyuXwSA9S,4,6,2,0,12
R_OOpSX3H9817QTCN,2,6,2,0,10
R_3ELOWwV4dz4knEq,6,1,1,0,8
R_1jcxmtjyYY2M1Hg,8,2,0,0,10
R_0iDriMaEuct22Yx,10,0,0,0,10
R_2XgSIZ1Mrf8bGXo,5,7,0,0,12
R_1dBkDO5MdFj9ZSP,5,6,0,0,11
R_3fIrZHMqdZU8mLl,3,5,1,0,9
R_2WvPp984edGFsOR,1,6,4,0,11
R_50zSOaRmEIdjSEN,5,5,0,0,10
R_2qBNeSaZeqy9D2E,7,2,0,0,9
R_PYGA1sx6hU2K6Xv,3,3,0,0,6
R_2TXzuZTl1O3CwqV,4,6,1,0,11
R_virY49y4XKAOnCN,6,4,0,0,10
R_UouH6A1ikAPk3hT,8,2,0,0,10
R_1q4B4nmqudy0krn,9,1,0,0,10
R_0uBDPBM7pvyCN3z,2,4,1,0,7
R_2usnJtWRPil9SCL,6,3,0,0,9
R_2S2GZVdod2Ansm8,6,1,0,0,7
R_2Ehr67ZHJne6th0,8,1,0,0,9
R_3oFOhhg21TZDAMI,9,1,0,0,10
R_z0uHfqkjeWfAQBr,5,2,1,0,8
R_3qPSESD80IOYR81,5,4,1,0,10
R_3kLeYaSZjtCQ1AM,2,7,2,0,11
R_1myKPPUa6il4nCy,6,2,0,0,8
R_1r7kJFbkOsXBsSe,1,6,2,0,9
R_2s5CUw8RsO6uHJy,6,6,0,0,12
R_1HjkyS3fZgosfTQ,10,0,0,0,10
R_1C89zsnsme4eptN,3,7,0,0,10
R_dgVaXfQx0P1XXhf,7,3,0,0,10
R_3KZ16isgHuJRI3S,6,3,0,0,9
R_1HiQ08wUcEpdjex,4,5,0,0,9
R_28B2JiclZNLQxls,6,0,0,0,6
R_pRfzm4oHMwQPQXL,7,3,0,0,10
R_1rDHpw0o3WbeFBH,7,1,0,0,8
R_22WSwFclSkf5BOX,6,3,0,0,9
R_1F31TCtq3D2rqTv,6,3,0,0,9
R_3qPedPHD0ET7rVf,4,4,2,0,10
R_3LXahUczvb0GJ73,6,4,0,0,10
R_3mmYPUODjNHDzXM,7,2,1,0,10
R_Ua2DmrEAVjOz2uZ,6,3,1,0,10
R_ukta8JQmbyj7Mhr,0,6,0,0,6
R_3G6xQw2z12TqEUc,5,2,0,0,7
R_1psLXh9nXklMSKz,4,4,0,0,8
R_2qaY4U1femxnDvX,2,5,0,0,7
R_Q0TOpkTTfi35IMp,2,4,3,0,9
R_3GuN68RW9nrPEsx,2,5,2,0,9
R_sdMfKmqE4bs5Brr,6,4,0,0,10
R_UzQdE9QeD3MEr3H,6,3,0,0,9
R_3k0ACsx5sEbvxOh,4,3,0,0,7
R_RQwP1p2C59xxQad,1,4,3,0,8
R_2AHFu6aEFWxtsRE,8,2,0,0,10
R_WwKnzf2AsxNDWo1,6,3,1,0,10
R_WqC1lxnBR1WQ8b7,4,6,0,0,10
R_3EWHxZgVn0sWd80,8,2,0,0,10
R_1cZJDr6Tvmv7e98,8,3,0,0,11
R_2ctQCYONk7UsV4f,7,3,0,0,10
R_21sKTCiHqeqAVRZ,1,7,1,0,9
R_1LMNwspp2cLbyzW,8,0,0,0,8
R_2CBoapDek0zXG5d,1,8,0,0,9
R_2QPBDl6Gtwc0PEq,7,2,0,0,9
R_21gLR0xk0kVKv8m,3,1,2,0,6
R_p44KricUwbFYh7H,5,3,0,0,8
R_ZK9VE6PWNVp9qaR,2,5,1,0,8
R_3iX1F9yIquKWPS7,5,5,0,0,10
R_1QlmrdSlzzrl7BE,4,6,0,0,10
R_3Gs0bMG8RCQCe3J,6,1,1,0,8
R_1fdPx5yMx7xb00r,5,2,0,0,7
R_2P5tOaXm7eEVrcm,7,2,0,0,9
R_1Ft6ziQqpdX9VjN,6,4,0,0,10
R_Aj9mVyzsSdKnOUh,4,4,0,0,8
R_UiRQgxplxGr1d4t,7,2,0,1,10
R_1NfB4S9JlYnKqgu,6,4,0,0,10
R_bDSxUO2Dtpq1HeF,5,6,0,0,11
R_2SxFoIThdSIQvK8,5,5,0,0,10
R_yjRlY29W81XO8GB,8,1,0,0,9
R_2aJO7Put3sCx6LS,10,0,0,0,10
R_3dGtwdnABZBwUrj,5,5,0,0,10
R_1MSsOEDwxAb3LAc,6,3,1,0,10
R_3D89TsCr8KGldxw,8,1,0,0,9
R_1IE6nFxtOETz3TX,5,2,0,0,7
R_8FZWNQjnqc0FI6l,0,7,2,0,9
R_2QRnMehnMvwy6OR,6,4,0,0,10
R_1Nh2D5KZXdPybwQ,0,2,7,0,9
R_1jMWH5OqTw1wTSo,4,5,0,0,9
R_xhonLJv0VUbTYu5,7,2,0,0,9
R_1mqplOTN071ihzY,3,6,1,0,10
R_8kdcpGgc2CGynEl,9,4,0,0,13
R_3gZURVVLPlXCOgx,7,1,0,0,8
R_3ekRYBqqEfCxyGn,6,3,0,0,9
R_42OJzcXAkWvcmnT,5,3,1,0,9
R_1mUSPtR8aX5mSHF,4,6,0,0,10
R_3RvBE9p12UkDjIe,7,2,0,0,9
R_1lAUouo4pl95LMO,5,5,0,0,10
R_31jdFmpzWGju3d9,4,3,1,0,8
R_1QshuC6QQFgpUiN,4,6,0,0,10
R_31KKzKIyLaCZwTL,8,2,0,0,10
R_un6GbCTMBzd5dUB,4,3,0,0,7
R_BttXWCyRul9Ah5D,8,2,0,0,10
R_RlPTSBVtLtbIJQR,5,2,1,0,8
R_11Z6tWsPNh4a9ca,7,3,0,0,10
R_3Q02Wtf9pUbxdiX,5,3,1,0,9
R_27V7a6ivFfpjrbs,7,3,1,0,11
R_21nWTgTvvIGBkpg,6,2,0,0,8
R_1er4lS8MUFxBww2,2,6,1,0,9
R_1E7n2wPLFKcgAon,7,2,1,0,10
R_1jfGVDMSMQ2LdKT,6,1,0,0,7
R_3P7Z5qvFdgIUtB1,6,4,0,0,10
R_OPSgsv3gu6evP8d,7,2,0,0,9
R_3NZYWLkYWBR0283,5,6,0,0,11
R_1OxEbUi1C1MOmCS,4,4,0,0,8
R_1BPCQ3zmBl3I050,6,5,1,0,12
R_3knBH4NDkgf4QYw,5,5,0,0,10
R_3LX4M7vUxI8fnjX,6,3,0,0,9
R_2SxFlx7DNeUyDZn,5,3,1,0,9
R_2Yt9cvU83bqRvr6,5,4,1,0,10
R_1K3TSCRC2Wgzbon,9,1,0,0,10
R_3g77DGCZVCmCeOH,7,3,0,0,10
R_2EAik02pIzaSQJz,3,6,0,0,9
R_3HXPX0VaHrDeciS,5,4,1,0,10
R_1dcvQLnkOahnh5g,6,4,0,0,10
R_2DSoNLqmIek5lBl,4,5,1,0,10
R_6xUolP1ylyj4Uet,1,9,0,0,10
R_2xwPFFR00LBjWpY,7,2,0,0,9
R_3emnzl2454OEesM,6,3,0,0,9
R_2Sc6dZ5Uozh9afy,7,3,0,0,10
R_2sX9mgQCk1sdIdB,3,4,0,0,7
R_1MKSAvXgqXvXBmj,9,1,0,0,10
R_29ph4IKSYgJwhpW,8,3,0,0,11
R_3OiWrDne0E3Glpq,3,6,0,0,9
R_9nmXc6un8XHyGRP,8,1,0,0,9
R_3HMLxWd0tj1lYbv,6,1,0,0,7
R_Rgd3CVBemqdss7v,5,3,1,0,9
R_3rMzAn42FHpLj93,7,4,0,0,11
R_2R3rXx4NYlYahDs,8,2,0,0,10
R_1rIajxUbGoev0KT,9,1,1,0,11
R_31d9dnYXwNcEjQZ,4,2,3,0,9
R_SI8Edy6olIBk5Vv,6,2,1,0,9
R_PvV6XfOlv7oZ1Hb,6,1,0,0,7
R_12a38u1Oj2OJFGP,3,6,0,0,9
R_3qJ0KjeJXudpqww,6,4,0,0,10
R_xipjmN0iQS0omeR,7,3,1,0,11
R_3LjwIndSSiv91FM,3,2,5,0,10
R_3EKAh0K4iHdV46b,6,3,0,0,9
R_9AKb2TeBhcMpiQp,7,3,0,0,10
R_27IRdAN9kHOZSwG,5,4,0,0,9
R_1GxnmltBmnlYVZP,2,8,3,0,13
R_3iKdeKDLB4lH4W8,7,4,0,0,11
R_1kOg1f3eXi9XcpM,7,3,0,0,10
R_1Q44o8dpAmTCstw,2,5,2,0,9
R_32JhlgUL5hoG8Jj,3,4,3,0,10
R_3ix28RFECKYn8NP,4,3,0,0,7
R_2P270HNzJRsuT8J,8,2,0,0,10
R_24FVpDE8JfDkFdE,3,5,1,0,9
R_3JhfkxMModyHaaJ,5,4,0,0,9
R_24ckY1bg4ce0VZo,1,0,4,0,5
R_3lsQ412kvToTmTa,8,2,0,0,10
R_8HQjqS5nbJHXjb3,7,3,0,0,10
R_oXNud3NnJEnhw9r,6,2,0,0,8
R_2e3gemrAdTyjrUl,0,5,3,0,8
R_SITMJygU4U6C3Op,2,7,0,0,9
R_T1srwMQNQRtGkw1,7,2,0,0,9
R_2343S0uovMVvtij,1,9,0,0,10
R_3j70M1Quf9AFzVV,7,3,0,0,10
R_82soGnjttKdnYXv,5,3,1,0,9
R_3EL2tJSlwKbnQn0,7,3,0,0,10
R_3dHfENdryDkwEpR,1,2,7,0,10
R_2wvpAG09E2vPSRL,0,1,7,0,8
R_1DZ3qCRs7foB8i3,6,3,1,0,10
R_9M2dHpTkE1tJsvT,2,7,2,0,11
R_3dS4vqWauJZpZFe,6,3,0,0,9
R_3FVUkdCwF6HSl64,3,1,5,0,9
R_3egYcBP5SlTQeJm,1,3,3,0,7
R_22rlb9Y5y7IQgN6,8,2,0,0,10
R_3qNHTIJyyq72Sdh,3,7,0,0,10
R_1mxWpyNo64QAn8O,4,4,0,0,8
R_9zNTDSCGL0v7Z4d,5,6,0,0,11
R_2VIO9OvSi8ZTcYt,3,5,0,0,8
R_2SIYrQztRGpyjrz,7,2,0,0,9
R_31gi9wDNko9fydT,4,4,0,0,8
R_PGnWQXO7bkCFTEd,8,1,0,0,9
R_2U30gSChUGlQFCg,8,2,0,0,10
R_1j9elUXgs6CY7Oy,10,1,0,0,11
R_dmuIIxqhlCR7aG5,3,7,1,0,11
R_3fjhPaej6syHwIK,2,2,2,0,6
R_12569WVV0gaTPbY,9,0,0,0,9
R_vN1LAmBCu14wIJX,5,3,0,0,8
R_aWA1TaYC4UivMv7,3,5,0,0,8
R_1K0ygXkEbalqUBH,5,4,0,0,9
R_eDNxtkQwRpySbId,3,5,0,0,8
R_3irFEzDPak6xWqe,2,6,1,0,9
R_1hxO6dZC9SobWsB,5,3,0,0,8
R_2cblbX4n1etHmDP,1,3,2,0,6
R_1PckAFBqEsNSIl9,5,5,0,0,10
R_30cz3AUFqYCuOLF,8,1,0,0,9
R_etWNn4AeNR77fup,5,5,0,0,10
R_3Krsq76oTaBqBC0,5,2,0,0,7
R_1oI0KeZqmpO2NYR,3,6,1,0,10
R_ZmdUe1RRfNaFPWx,3,3,2,0,8
R_3sslcbxWkua1UM4,5,1,2,0,8
R_2TMGImtjQ7MHlA0,2,5,2,0,9
R_3CBpWJD3jfokmRE,3,7,0,0,10
R_23eHPkMEkkFyrbt,6,3,0,0,9
R_31KNRa8cquTAETF,0,5,4,0,9
R_24of9dbcPCptdfg,5,4,0,0,9
R_12mNNRF9XB9kcQl,3,5,1,0,9
R_Byq33uYt9a9I22Z,7,3,0,0,10
R_3MgngSlilO9XCDT,9,1,0,0,10
R_2S9mG784nlCa3yd,5,2,3,0,10
R_1Cw3opKQZYdNhuD,8,2,0,0,10
R_O75ZLiptvkVbLIl,6,3,0,0,9
R_3Rf2vqW9CwT6bOD,6,4,0,0,10
R_1ly2sX5NCpK8eOt,5,4,0,0,9
R_2f10q46jrg4J9vi,7,2,0,0,9
R_UyVEKLAWfvQKUsp,1,5,2,0,8
R_1eORXudgfSjPOYW,4,3,1,0,8
R_2uQyedGbkqVSMf3,6,4,0,0,10
R_a66hyRblh6yK8eZ,3,7,0,0,10
R_yR20rQ6zXErCMJb,5,2,0,0,7
R_dhUDMSbvTaV64cp,2,1,0,0,3
R_2s4qtPGAJkgq4vA,11,1,0,0,12
R_2SozIBhCPBFjAYA,9,2,0,0,11
R_2PBQOBjJNZempqX,3,4,0,0,7
R_1FqTI6EPgb5JXY1,4,2,1,0,7
R_21Bqxn0waZB8YYd,5,4,0,0,9
R_1OuzW1HS3KYcMkq,2,3,0,0,5
R_2wsswkRZYUkojLO,4,4,1,0,9
R_23TwqiF18t4dQ2T,9,3,0,0,12
R_3iBTRicT0q9P1zi,5,2,0,0,7
R_3dPTnbjlBPR6Ztk,5,1,2,0,8
R_3iJZBpIU4jpOI2k,7,2,0,0,9
R_1LvVnstiQFvcQ2s,7,1,0,0,8
R_YStFZyShPece5Hz,6,6,0,0,12
R_80ojhV4lw3mO8dX,9,2,1,0,12
R_2pJIWbFsoCyNkqh,5,4,0,0,9
R_3LiK8iRBizAOhd5,6,3,0,0,9
R_2AL0dBN37SX6mpf,6,3,0,0,9
R_12nn67r3DRsNus2,8,1,0,0,9
R_2uZL8XAZ9GPQOmE,2,4,4,0,10
R_vwYfHNqw4sXnbEt,8,1,1,0,10
R_1Ie32YhCVIL8nUl,9,1,0,0,10
R_2uKfugkYlR7SNrO,7,1,1,0,9
R_3GiIWe6NV3MbRa4,7,2,0,0,9
R_usNCtZSvMVG0iWt,7,2,0,0,9
R_T1R2KedIhkEWebv,6,3,0,0,9
R_A0qdb9gJFJciwUh,3,5,0,0,8
R_3fpXuXkLJayIAV0,2,6,0,0,8
R_3fklaCV8mMpXhMD,3,3,0,0,6
R_3NVwWz5MRL1Y75U,8,1,0,0,9
R_2qlOzXcegQ7Qqpq,4,4,1,0,9
R_3GwA3kmDwjWawkg,4,3,0,0,7
R_2arz0c860tt1UtB,7,2,1,0,10
R_2VPCaQBmps9mRN2,5,1,0,0,6
R_2aIxMqsvPixzCCB,6,2,0,0,8
R_2CVsjzJMoK5e17Y,4,4,0,0,8
R_1jH4cFmKAu2CkG3,2,2,3,0,7
R_1E7r4w3bA732lKs,9,1,0,0,10
R_1BRvEl8M3Alwmrb,1,8,1,0,10
R_11YDhtjWr7x7BdI,4,5,0,0,9
R_114sFw0jHmKnpNw,5,6,0,0,11
R_Q4lDK9rw3LqRwBz,5,5,1,0,11
R_3dS8J4DH0olTHEy,3,3,0,0,6
R_UF5qLHoa2oJWwH7,5,5,0,0,10
R_24of9dbcPCptdfg,5,6,0,0,11
R_3QFzXSW1Lk6RKoH,8,0,0,0,8
R_3EA3m9Ths0bTJwd,6,2,0,0,8
R_XsPruqSQssHDlcZ,1,3,1,0,5
R_3KBAGbmLePqahm6,5,3,0,0,8
R_25MjmIh2p5HVFth,6,8,0,0,14
R_1kFdiAxu6hv2Xu5,7,3,1,0,11
R_3L0bZ3TrNnHoyIy,8,3,0,0,11
R_WoOjBkLtCwcovkt,3,6,0,0,9
R_3psDOc9SBuIo245,0,3,5,0,8
R_25GA7jRZ5LMFkxA,4,3,2,0,9
R_1q8SjvsNfTTsGv0,4,5,2,0,11
R_1gvcKL4JfjXka5L,6,4,0,0,10
R_1ddjUykCN7tenwd,6,1,0,0,7
R_2fr83I2AvDrFPi1,6,3,1,0,10
R_3rNwd4H5VdeGyoi,4,4,1,0,9
R_3fW2SIfTDBznsQz,5,3,0,0,8
R_ez0Ejh7d5D9A4p3,2,4,2,0,8
R_sZ6k5KBPPjmBO2l,5,2,1,0,8
R_2QfjS2sAwMpLzs1,7,2,0,0,9
R_1f7nykngOeEPH3B,0,3,2,0,5
R_2R7CR7gUnuNJ6yu,5,5,0,0,10
R_1gTtfaXGHM5oglW,4,2,2,0,8
R_1itfD2Lg8dgbe8Z,6,3,2,0,11
R_2CDk7iGTjxdnVx8,7,2,0,0,9
R_tGTxTHIy7kCswG5,5,7,0,0,12
R_1f2FYBBqVmT9JCU,4,5,0,0,9
R_3gUhk8mH63Bitzv,2,7,1,0,10
R_2wKSiPEzBq9kBf9,2,5,3,0,10
R_2s72FQhpLHMAVAh,8,1,0,0,9
R_2fJq3khYzddCyMG,7,2,1,0,10
R_yyHHgVslWlEBWEx,9,0,0,0,9
R_1g0fgAohWnqgS3L,1,9,2,0,12
R_2WPbUulTlYuaNp4,1,4,3,0,8
R_3GjtvM0genrELIq,2,5,2,0,9
R_2CuXG9KlVwIQGZ6,4,2,1,0,7
R_3rOkwyKTNE5qLgd,3,3,0,0,6
R_UFmXTQtTAla78cx,5,4,0,0,9
R_2X1k1q3FgYy37Q3,8,1,0,0,9
R_0PAh3H6x16DaDMl,5,5,1,0,11
R_1ojv6YIXEzswQr9,4,3,0,0,7
R_WBfQd03aNif0FfX,6,3,0,0,9
R_1Ia4MFVaoczofli,8,1,0,0,9
R_1qeKPRlnf3E5JMP,2,5,0,0,7
R_3Grp1R6JC5JL8Iu,5,0,0,0,5
R_1LLldmaHICSyX8d,0,3,4,0,7
R_3k62n54Nbdx4mTG,7,3,0,0,10
R_33kkiUlKa2BcQ5d,3,4,1,0,8
R_2Vyzg0gLGmCuMgk,2,6,1,0,9
R_OBZXSoqqyqSoly1,4,1,2,0,7
R_1Ny6zHNf7MSdZeU,6,3,0,0,9
R_1ePFzRQDj93JsPT,3,4,3,0,10
R_28FzQUbiSz6N15X,6,3,0,0,9
R_2Qhvi1Cbopd6cc2,2,6,1,0,9
R_3DeE1vmeME2Kzk6,3,6,0,0,9
R_RRn8BGCt4YLSuE9,2,4,4,0,10
R_1KiQjhxprv3aYar,2,6,0,0,8
R_31ZViavjaRVl4Dv,8,5,1,0,14
R_8vQaRuirDa0vCjT,5,4,0,0,9
R_3Hh5l50lPpzwUaj,2,3,4,0,9
R_5juqYA0aOoU5Hgd,3,3,0,0,6
R_1lylubn9md3KNsj,4,2,0,0,6
R_31zxckT2SjI7aco,6,4,0,0,10
R_3lYOjp39LcYpaHz,0,2,4,0,6
R_06NFqt5AqibUu7n,2,6,1,0,9
R_0HYVNttV2Ta84N3,4,5,0,0,9
R_0qcL31Za54NO34J,0,0,7,0,7
R_10vMNB3VlGrwnai,1,5,1,0,7
R_11gtzYfk1Gihv9X,8,1,0,0,9
R_12JfCzqJtcP0cAB,1,5,1,0,7
R_12xwfP1nYbfsuBG,7,3,0,0,10
R_12zExRWQqRlycqY,6,1,0,0,7
R_12zJKuNiURN8NcK,6,3,1,0,10
R_1dGKwE7HTSvyKOw,5,3,0,0,8
R_1dGpX4NZEGuLU5X,1,5,4,0,10
R_1DMvcIN7FleII1x,0,1,4,0,5
R_1EbMoKBgStkud4O,4,1,0,0,5
R_1EhqdPnKkLQvtQO,1,4,0,0,5
R_1EXnlRaZ2X6m8lF,5,5,0,0,10
R_1f9IKN3E0vsSTDV,8,2,0,0,10
R_1FbI9VpRSqc3WVd,1,2,5,0,8
R_1FFYAN2hOtUWLN5,4,4,1,0,9
R_1FtcvgwV5JyXcUb,5,3,2,0,10
R_1GJS1QqqYbVvxoi,4,2,3,0,9
R_1gu423UPFXBzr3y,5,3,0,0,8
R_1IMB2Ssdnw74L93,6,3,0,0,9
R_1iqA9PMH6TjisO8,5,5,0,0,10
R_1jdpdQwPyILYBfH,6,1,0,0,7
R_1JK5Hi0yCi15QBb,2,8,0,0,10
R_1KdbhpeSCCJlw9W,5,3,0,0,8
R_1kHqPi87OcAs1uj,3,4,1,0,8
R_1Kmb53aNe928jql,5,4,2,0,11
R_1Kr3l4z8YFKI92i,9,0,0,0,9
R_1Kwj0FmGW7tJYXX,4,4,1,0,9
R_1LM7uZQ2IYSoikR,7,1,0,0,8
R_1Lo24aUyjf9bMo7,6,2,0,0,8
R_1LtgTkwXdjmMpMg,8,0,0,0,8
R_1ltL5SatqWDLp9H,3,1,1,0,5
R_1mEoWllPRoyUQWu,8,3,0,0,11
R_1mVshxfRNhkNlv5,2,3,6,0,11
R_1mxvSEOTt40OBkn,5,3,0,0,8
R_1NaKEDCMCPWG3Ao,7,3,0,0,10
R_1Nam8yY5KQgCKNj,2,4,2,0,8
R_1NCCuKELb1amnwE,5,3,1,0,9
R_1NrcWxwe5ifFAXZ,1,7,0,0,8
R_1o6J2E5wyRmnh9V,4,5,0,0,9
R_1oA5679ETBhDAkl,6,2,3,0,11
R_1oc2vIym95o7f9z,1,5,2,0,8
R_1OjE9oZNC9Y50jN,4,2,0,0,6
R_1P18Wj9vDiMC5nE,6,2,1,0,9
R_1pm7vSf0aEQ0sJ4,5,1,2,0,8
R_1PS4be4ooxDIwTD,4,5,0,0,9
R_1pte10gxI6bdRaR,1,4,2,0,7
R_1r0ObWxuIifRLYx,4,4,1,0,9
R_1rO1euJCwiPIehY,5,2,0,0,7
R_1rwSDg7CdvGkRb2,6,3,0,0,9
R_21htjwl02UT1ML0,3,5,0,0,8
R_21ySaDlALG0OQSt,3,4,1,0,8
R_22lgYGCr2D3WVRi,3,6,1,0,10
R_22Rj66SbCvykfeA,4,6,0,0,10
R_237Fms45ELK5Ir4,3,3,3,0,9
R_237TG8ZM6XO8kRS,1,0,8,0,9
R_24OZ61Cpke1CEjf,4,3,0,0,7
R_24pb6nghK177l7t,6,2,1,0,9
R_24u9OGHh3L4zU1O,8,1,1,0,10
R_24zQG1CRsjhuLEQ,6,1,0,0,7
R_27VG8ZU83l3ELqz,3,2,3,0,8
R_27VTv1XH4zyFGwl,5,3,2,0,10
R_27VxkbFk8yHzjNR,2,5,1,0,8
R_28Pa9ymvu1VpT2P,5,4,0,0,9
R_28ZoQHDGXvlIeLr,1,5,3,0,9
R_29c3MyfvJGbBJN4,4,4,0,0,8
R_29ttNDOSsfB8SyV,7,1,2,0,10
R_2aqJT1GZBuBnT7C,3,0,2,0,5
R_2B5V7bG9yl3hSH2,2,8,0,0,10
R_2bTomQp1TJjPucv,7,5,0,0,12
R_2bUJOpaDT5X1k8L,7,3,0,0,10
R_2cdvVoLL6S9om7p,1,2,2,0,5
R_2CEtJ0y1iiGfagX,6,1,1,0,8
R_2cpWM56vlDBLLxQ,1,3,1,0,5
R_2Crenpbf3n9IljV,3,6,1,0,10
R_2cux1cqdfri9zkn,3,2,1,0,6
R_2D5ieJwMMzg8IHR,4,3,1,0,8
R_2dG5LP3VR47BRtj,7,0,0,0,7
R_2dhVjweMTRFOMew,7,0,0,0,7
R_2dXEw0vjbZqsBUP,2,5,0,0,7
R_2EgUvvkT9LIixDs,2,6,1,0,9
R_2ffeUm9VsB6FyPD,2,1,1,0,4
R_2fiCpaYYpqwCYMB,3,3,1,0,7
R_2fvLy5ogK60Nalo,5,3,0,0,8
R_2PzinPwY00oDSTs,0,3,4,0,7
R_2q3sxp27cncRin4,5,3,0,0,8
R_2qk405u0F7cp4MX,2,3,2,0,7
R_2QyuwdLuiQ6fcrt,2,5,0,0,7
R_2rMJERlmfSrcAP1,1,1,2,0,4
R_2ro7F9RZCZuCUTq,4,1,2,0,7
R_2rr4sAHoe1ROlbB,3,3,2,0,8
R_2rTt8n0GnnsElAW,8,0,0,0,8
R_2rup5KF0Kp4adpS,4,3,3,0,10
R_2s5xffJIYbpMhLn,7,3,0,0,10
R_2SIXN9KTTMtyVlE,3,1,2,0,6
R_2sTlVdfKBJzsvoo,0,4,0,0,4
R_2sWLLVdxXszLi3s,1,9,0,0,10
R_2t4L0pu76WIo2zX,3,2,3,0,8
R_2TsKevotE0n76vY,1,0,3,0,4
R_2TTO9WceVZT6YiE,8,1,0,0,9
R_2UVgkCr7AT1YQkm,0,5,2,0,7
R_2uWLDmQPXLwkpZf,1,5,3,0,9
R_2uxDGB0UbJaNTx8,5,5,0,0,10
R_2VCtfmOACnBiQC0,4,2,0,0,6
R_2VKEOejZrGArC5K,1,6,0,0,7
R_2vljYtM7EdfCyR3,2,4,0,1,7
R_2WB6IKp2rwLfxSF,1,3,2,0,6
R_2X0ZaT00vqPixxS,7,0,0,0,7
R_2X50lmyvQrBCJAQ,7,1,0,0,8
R_2Xp4q3LgTuT18rg,2,2,3,0,7
R_2YlJZ9sA5z538CO,4,5,2,0,11
R_2z5Oi1dCoQe9xBJ,3,0,0,0,3
R_2z7x2snRSCVoy8u,6,3,1,0,10
R_2ZDlFlHLhX2IgYW,1,4,5,0,10
R_2zea58ATSuAkZxe,2,8,0,0,10
R_2zkAHESBbwBU8Va,6,3,0,0,9
R_2zYEJ0Me8ai4RHJ,2,5,0,0,7
R_30lbNeFCotlkaW8,3,4,1,0,8
R_31bLtLMfmmKcuIG,1,7,4,0,12
R_31t8aszy4kWYntS,4,5,0,0,9
R_33BilodG54ztYGv,6,1,0,0,7
R_33D2p7jHKB62Mq3,1,0,5,0,6
R_33fiyGIWhVVLJqk,4,6,0,0,10
R_3CJyQ9j7lIfk6mL,6,1,0,0,7
R_3DpDhlL9Q9BUdke,5,4,1,0,10
R_3dR4K4yLG6t9dw3,2,6,0,0,8
R_3dygutswWZHf55f,0,4,5,0,9
R_3EFi7T8wQCWwIz8,5,2,0,0,7
R_3EHbX0SXvCH7KaD,1,5,2,0,8
R_3EiGrcsEBRiEMA9,10,0,0,0,10
R_3EKMaclblNsGjbB,6,3,0,0,9
R_3emddhtB86PXjRX,6,6,2,0,14
R_3EojUHXQPKYgm8D,3,3,0,0,6
R_3es1i2hLmDJHykG,6,4,0,0,10
R_3frZQQFdSSjSChV,4,5,1,0,10
R_3FXnbHWqrmqqU86,7,2,0,0,9
R_3G9b2A4cKOEj0Hk,6,6,0,0,12
R_3Gy6TNK79KHuf9W,2,5,0,0,7
R_3h3gnfKgLa7F0tO,5,1,0,0,6
R_3h3gP0yxPI8mmDr,6,0,0,0,6
R_3ha8OZb7PkAO0Xe,10,0,0,0,10
R_3HJUXtCB1ATAWFb,1,2,4,0,7
R_3hn1R61Fe1S5pip,4,4,0,0,8
R_3Hn8urbb6d2pCzv,7,4,0,0,11
R_3HOzrdvriPxVjDW,6,2,0,0,8
R_3HRiz0gmXor5nnd,6,2,1,0,9
R_3htDIRUMKPNXqvq,0,2,3,0,5
R_3htlXs3XR84e1Rj,7,1,1,0,9
R_3Iac2zHHBn0AVAO,5,4,0,0,9
R_3Iav7WBbkSCUw34,0,9,0,0,9
R_3iqD5BsnjLFIma8,5,5,0,0,10
R_3iro7FrCSfWH27C,0,7,1,0,8
R_3IXfQ0cD1IdilLK,2,2,5,0,9
R_3Jk4v3gLB589wlj,0,1,7,0,8
R_3Jztf3kpyFMWyLo,7,0,0,0,7
R_3k0rQjkNKO9wVKS,4,4,1,0,9
R_3kIlWVpv0RbWrVg,0,7,2,0,9
R_3kt2gGyJ2egQeQ1,2,5,0,0,7
R_3lVmnkawcyUs8tN,3,3,0,0,6
R_3LZrb2ynO0wkXw6,5,4,0,0,9
R_3Mlm8MWhlAiSeGe,4,3,1,0,8
R_3NCC4PMmyS132xy,9,0,0,0,9
R_3nqMMnOQDnzx7wd,5,3,0,0,8
R_3O0RtwK4ytxC0Dq,1,4,3,0,8
R_3ObBK9Fo4s3PYL7,8,1,2,0,11
R_3oMHzaDYHxjvKIs,1,2,2,0,5
R_3oSFaaphWKmcM8q,6,4,0,0,10
R_3oZMFdXT0qNtpIX,3,4,0,0,7
R_3ozmXjJQDFw0iv3,5,2,1,0,8
R_3p2TOO4VbPyjFf1,3,5,2,0,10
R_3PTZd4P2KAA67aM,2,5,1,0,8
R_3PXf5VuoACyG21U,10,0,0,0,10
R_3QPelvA5CAph1CF,6,1,0,0,7
R_3QWSHmmOqQvhLUR,0,5,3,0,8
R_3rV3A7J9v9yU0lx,8,2,0,0,10
R_3sa9EcUHAcIlR64,4,5,0,0,9
R_3stdn3AU4ajO2kk,6,1,0,0,7
R_3suHhe26ygtJEN7,4,1,0,0,5
R_41R9INGcP4sTGqR,2,3,4,0,9
R_5aN6dOtQjGlSDId,1,1,5,0,7
R_5imZIwH2fuCn7YB,3,5,0,0,8
R_5zGeKVQSkgsZ6mJ,5,3,0,0,8
R_6nWGHVcAQ8BhQZj,2,3,1,0,6
R_6uvUlos3GUgxt05,2,3,2,0,7
R_6xlqZB5zSNHifWF,0,2,5,0,7
R_6xpcYvzomAfkD29,0,5,1,0,6
R_8HUGEFfa0Rm1YEp,2,5,1,0,8
R_9Y6yyb25FkStRER,1,0,4,0,5
R_ac7JF4QxfJNd1Wp,7,1,0,0,8
R_AdPS4bCpyji9mQ9,5,2,2,0,9
R_ApJBCfw4abr77fr,1,0,6,0,7
R_b9s29Q3zRv20r05,5,4,0,0,9
R_bapG0bZsRVSyMOB,1,5,1,0,7
R_bDhIBCITOVngeL7,4,4,0,0,8
R_bOeVTMpRdTuZDRD,4,4,0,0,8
R_cDeTPoehcmn4RmV,0,2,6,0,8
R_Ce8mA7QWltntGeZ,1,2,4,0,7
R_CmJg3JsSGw6MqDT,0,1,4,0,5
R_cMkQGZii2qrMVO1,6,1,0,0,7
R_cTNrv7maWDuAkbn,2,4,1,0,7
R_cw5uaqSSnYgRS8h,5,5,2,0,12
R_D7reae2pdABB8wF,5,4,0,0,9
R_dbXZZEzam7BQckp,2,2,3,0,7
R_DtJjbcFSaPwe4YF,5,5,0,0,10
R_eD1qsc0aLufmiRj,7,1,1,0,9
R_OCoOZHfsjmNo8kF,4,2,2,0,8
R_OHV8f6C1bIZfQ2d,7,0,0,0,7
R_OJqLrsHjPqirHah,9,1,0,0,10
R_OpLhVjKC44TAjdL,2,4,1,0,7
R_PCdYhXbrJngbAGJ,5,3,0,0,8
R_pmbHi4wtVzQYd21,6,2,0,0,8
R_Q4kfB2kO5OHfm3D,10,0,0,0,10
R_QbnNbNDrDrPB9GV,0,3,3,0,6
R_qKpogTSyTpQCfTP,5,4,0,0,9
R_qO6OvzWIzgTkKWt,3,2,0,0,5
R_sbZLmchgjOxcXT3,1,4,0,0,5
R_sjnPh63dK0Dusz7,5,5,0,0,10
R_SUGncVyjaSHdd73,5,4,2,0,11
R_T28q0PYxF4zBFDj,2,3,1,0,6
R_TnhLEIysve293Y5,7,1,0,0,8
R_ua0hXolcow5bhKh,0,2,6,0,8
R_UAAbNU478MWrvI5,3,1,2,0,6
R_UamXc3EW9nlHBLz,1,4,5,0,10
R_UcoD1OH5wly21uV,3,4,0,0,7
R_UGsGFRS4WFfL81X,3,2,2,0,7
R_vNwoafMO2eSFrWx,4,4,0,0,8
R_VOycHvcWtShDI5P,5,1,1,0,7
R_wKUecG8FOOpW9UZ,1,1,2,0,4
R_wN8TVPcd9dsSwnL,0,0,6,0,6
R_wRxvf6K847CG1Ox,7,3,0,0,10
R_x4xFrfCsH1dcWyZ,3,1,5,0,9
R_xF4fSTaBVDpTdDj,6,3,1,0,10
R_xhkEGawrVFl46mR,7,1,0,0,8
R_XHUyKFxb0uB5iKt,3,5,1,0,9
R_XnpN0VdN9wf9KCt,3,6,2,0,11
R_Xpj8xlXOQMF9i7L,5,5,0,0,10
R_XWUXi4TPlvzuWL7,6,1,0,0,7
R_ymtQs8BG78wttO9,5,1,1,0,7
R_yORlmWvNONLMUCd,1,1,4,0,6
R_YWXMfk6C9pRJgSl,0,2,4,0,6
R_Z9K7AZQrq7t6zBL,1,4,1,0,6
R_ZaREq21NmKzpSkp,6,1,0,0,7
R_Zaxf91fI0IW0W1H,3,5,0,0,8
R_zVx8zNdbz21xncB,8,0,0,0,8
R_SJXtc8U1mS6rrOx,10,0,0,0,10
R_xg5MgarJprox0n7,5,2,1,0,8
R_ROIdYA1ZocZrmJX,6,1,2,0,9
R_4Oemtqa2m1DGHCh,5,2,1,0,8
R_3I5XIjfHkQjWTjY,4,5,0,0,9
R_9ugdBtXZqXwtX3j,0,0,5,0,5
R_yJWqK3tVYZF9I2t,6,1,1,0,8
R_2Wu0D9JJlOIxC8F,6,3,0,0,9
R_24dS4dciJvGwI4n,4,4,0,0,8
R_2f0DfJ1ZoPmNnOS,5,2,0,0,7
R_Rli8fx5HL2OoqI1,2,5,1,0,8
R_22xMQYkRGQQlh20,5,0,0,0,5
R_Ua8JMdFwRL0Bh3X,2,3,1,0,6
R_aXgvnii4b5BPUvT,2,3,2,0,7
R_12gbFwmx9WHGHCV,4,3,1,0,8
R_29gd7psvXaArFZU,7,2,0,0,9
R_3lYw7sUG5AYciKY,6,3,0,0,9
R_3jZhSMLKmPmh17O,1,4,0,0,5
R_1PTLZWBJysuBpq1,2,2,3,0,7
R_33fonWrtMQwY4ia,0,4,6,0,10
R_0TivUGNPSj03iYp,3,5,1,0,9
R_2uBpQX1FJq2ZFF2,4,5,0,1,10
R_27lnUFRD8l3vx6i,4,2,3,0,9
R_3005dQeHrV2AkGj,2,6,2,0,10
R_11dVoRE6oq5CPEW,6,4,0,0,10
R_WCHruf25nHFYdI5,6,1,0,0,7
R_Pv1lYCkBzuNS6yZ,3,6,1,0,10
R_3QJkXzpj0UtLGrx,7,1,0,0,8
R_2bHw2bJpo6XgsWy,3,3,0,0,6
R_3hEoY6uiKvJDW6H,3,3,0,0,6
R_3JrN3WhRLuEYKSd,0,5,3,0,8
R_2X7D0wUElJ4pKYB,3,4,2,0,9
R_3Grlhk4OEz8AbeU,8,0,1,0,9
R_30w9ZpuvNrZGr53,3,7,1,0,11
R_3qfEAQPPVkFfgdy,3,8,0,0,11
R_yyCpbvmOXGieRTr,1,3,2,0,6
R_3DvTQt13NxIRk1e,7,2,1,0,10
R_1EcHUBxE4KdqPsl,5,5,0,0,10
R_3HSnZgIeUo0rYVQ,8,2,0,0,10
R_cPiCSfIZJPBSitz,0,5,4,0,9
R_2qjGDSONnu7tZit,7,2,0,0,9
R_0Tf7cdGnMbhFv4l,4,6,0,0,10
R_3O0n02IqRKNZYM3,3,3,2,0,8
R_25uBpoOCbMqMhmd,7,1,0,0,8
R_4ZQNkrQIotlKx2N,5,2,2,0,9
R_3Jlv3rf9vJ1JDxM,2,6,0,0,8
R_3oG60vtMHDtw9nM,5,3,0,0,8
R_2wnQnlnyIFIosWW,3,3,3,0,9
R_1gIV58JZB8NSrqp,2,7,1,0,10
R_3irjVfAmFYlrm26,5,0,0,0,5
R_1mC7rBrX7rGK0Rb,5,4,0,0,9
R_2aVrS5MVJdpICNH,2,2,3,0,7
R_1FFXAoH2rYDDVy6,9,2,0,0,11
R_3stE2zI2hk255lM,7,1,0,0,8
R_WqHkqSjbmutF9Hr,5,4,0,0,9
R_2E0NML7ONZnW79B,6,3,0,0,9
R_1cU0wqbxWuVMSGg,7,2,0,0,9
R_3IrwjOghr869BPH,5,4,1,0,10
R_31iQPpzcz3fXz4T,7,2,0,0,9
R_0TGdeHXXocTGTHb,5,4,0,0,9
R_3fTzpOVipwzlIkR,4,4,0,0,8
R_DCcG4tVZEcH7tPH,9,1,1,0,11
R_0ilNKCazJqYAtEJ,1,4,4,0,9
R_33DRQrFryED1RQ4,0,5,1,0,6
R_2XmtoOEogPDgfy2,4,5,1,0,10
R_3D5fVmvopk2Jdcz,6,4,0,0,10
R_1dFy5HLSJtJXwHR,5,3,0,0,8
R_3FPxwrNKs7evVFM,6,3,0,0,9
R_233rN6a1JaWIogi,4,2,1,0,7
R_5bR5QkWbflS7Mop,7,2,1,0,10
R_4NGW8efu8WJNGYV,5,1,2,0,8
R_py3IYjIvfqgmnUR,5,2,0,0,7
R_12m907aDYMqMgLa,2,3,1,0,6
R_2pSQ678yk28VvOY,5,4,0,0,9
R_2fa4R0kw5lkc1hl,10,0,0,0,10
R_1N2MmalA6RRbIOj,2,7,0,0,9
R_OoHz0kfYeP2CqsN,4,3,0,0,7
R_p59jpAtlsUwGUGR,6,0,0,0,6
R_2DZei7Ry1sWpyqy,2,5,1,0,8
R_3EG3HzcxUuXXBf2,5,5,0,0,10
R_24jbOHrTx0ZY4Bi,7,2,0,0,9
R_2sSImvpkm7YLUZo,4,5,0,0,9
R_2D2obGsE35DJXem,2,5,1,0,8
R_3PZvm7LUfepEwHX,5,5,0,0,10
R_9GfBv4tpwx6IpDX,5,5,0,0,10
R_31bFb7hwGC9Gale,9,1,0,0,10
R_2CPu5ySMkdOk2sV,6,3,0,0,9
R_12fOBbeHW3pDwPD,4,4,0,0,8
R_3hn1F1F91MGP7nV,8,1,0,1,10
R_3MJBtMqihqkRn2C,4,4,1,0,9
R_23gJWtnE6FRAN1c,0,5,4,0,9
R_3IWeABZNr5YeywI,2,0,0,0,2
R_28HCWXPU5cA2XTl,1,7,2,0,10
R_5mB2Sdu2zorC44F,6,4,0,0,10
R_1Nns1Vqa1nRoG1r,6,3,0,0,9
R_3PMo4fbO9OPD3sJ,5,5,0,0,10
R_ZktVCuSAkW8iaYh,8,2,0,0,10
R_1rHVJFZYTi1r0Au,3,3,0,0,6
R_yEg899ILCugttDP,9,0,0,0,9
R_3stU2DDJHvGdYA3,3,5,0,0,8
R_1qTVd9Bh6OhCpVn,7,1,0,1,9
R_3Q0nZjubeuX5MHf,4,4,1,0,9
R_1rCBM6nlOuPyVcn,4,4,0,0,8
R_YctxqDFjCAVfsml,4,5,0,0,9
R_25BhRGUoqam48tG,3,5,1,0,9
R_28XQDEanjHb314G,8,0,0,0,8
R_3oXGesP0cZWdqj4,2,4,3,0,9
R_3HqqLSXMAwNGUw4,5,1,0,0,6
R_22rj8tmBV9tZdOh,7,2,0,0,9
R_2bN1BWnpKFCSRKe,3,9,0,0,12
R_2woZgY7Ue5blHdT,0,5,4,0,9
R_3dRM5GK3IBIYCor,6,3,1,0,10
R_1mDH17lNVNPdLnG,4,4,1,0,9
R_11gW7ZnqPWvC3fs,2,4,1,0,7
R_3fDISaN5dznyBmw,4,5,1,0,10
R_T59y0lHe1NZi9wJ,8,1,0,0,9
R_31u3U8Rxcr1tiEk,5,3,0,0,8
R_1Ft56HuqFeYP5wP,6,2,1,0,9
R_3DcpdYXsPLrx3PZ,7,0,0,0,7
R_W6VlKqMjbBPFChP,7,2,0,0,9
R_2Qyehatw5NCccYO,1,6,1,0,8
R_2uP5g7NbjHt7V3c,1,6,1,0,8
R_W2tq1iM6FZQhpvP,8,2,0,0,10
R_cN2ujChROIj70Rz,7,3,0,0,10
R_3fPseBOhxlrU9KB,1,2,5,0,8
R_31g9BbF0xrFHCzy,7,3,0,0,10
R_10Oc8GPViUjNjUa,5,5,0,0,10
R_2TBljHJynf3hSMX,2,7,1,0,10
R_1K8BkJ2RNjsD9AB,3,4,1,0,8
R_dhDmPwHoat2AfXb,6,1,0,1,8
R_2uywh5C6juSSpzx,1,3,1,0,5
R_1LUzqVi4TA9yaio,6,0,0,0,6
R_2BtUGYedGWaW2md,3,4,0,0,7
R_12mV1kwWCryVUZB,4,4,0,0,8
R_3ni7dhjH94jFSwo,0,4,4,0,8
R_3Rg9bY00WzUpP0I,3,7,0,0,10
R_2R3SmATF92Pcyeg,1,7,2,0,10
R_3KHh5cfRTUiIcpe,6,4,0,0,10
R_3kG0RhLqKM4ggLE,7,4,1,0,12
R_3D8CKP3hcXHCZT3,4,5,0,0,9
R_1K2vRGqdYIUNWPi,8,3,0,0,11
R_509rCOCsmhEs6T7,9,1,0,0,10
R_w60qeL8dAFeY4oN,4,5,1,0,10
R_1dMpWBT1pKBD9ZF,2,7,1,0,10
R_1IK942146zHDyEF,4,6,0,0,10
R_r8bCtGr8LFSW1y1,2,7,0,0,9
R_xbHn1eyrGQmwSjv,9,1,0,0,10
R_UGFPnEnbenWDVsZ,2,4,2,0,8
R_3PHtb624U8PQyVQ,4,3,0,0,7
R_2fInllJBeYg6w8g,5,6,0,0,11
R_3MJQP9RddTp2e7X,9,1,0,0,10
R_1pVFT7Vv14FipGp,5,3,2,0,10
R_1HkIl0gWR4emHRQ,9,1,0,0,10
R_3NPA4Y47WhxmIuM,6,4,0,0,10
R_28MqhaSFW1zeNBa,1,6,1,0,8
R_2R4cQ4jtjSqkyDA,7,3,1,0,11
R_0SQGOarKrglg7El,3,6,0,0,9
R_1N3cx44HAIlbUyn,1,3,3,0,7
R_1oAuKrEIswxabho,1,4,3,0,8
R_ZmifX5zXVzheAg1,2,5,1,0,8
R_3LiNCaNLJN3iKKn,6,4,0,0,10
R_3jZpEdiMviEk5tk,7,3,0,0,10
R_3QEKWAOoTZfdta6,5,3,0,0,8
R_1Nw6BtterdSP201,1,7,0,0,8
R_3KoOsChZBRFvCeZ,3,7,0,0,10
R_2pRcQ0OYuobsu7I,8,1,0,0,9
R_12zCzQL0DOiXoA0,0,5,3,0,8
R_2aWtb4lLSu964Sk,4,3,0,0,7
R_3DiqoWEIB3p0rwj,6,2,0,0,8
R_3Rln1CnWWPyCQOT,6,3,1,0,10
R_0IXNGUE6itAkQh3,5,4,0,0,9
R_3Jq4FuG2xyFC64d,4,4,0,0,8
R_10HRS7ylvQc81NO,4,4,1,0,9
R_2PojIETdYd3lbeP,1,8,0,0,9
R_3HGCsf4ymhmHak9,8,1,0,0,9
R_1g0E8HsJcsnuOjE,0,4,2,0,6
R_ZDKksaMKd6bYA6t,5,3,2,0,10
R_20MSwl7pPETecXC,6,3,0,0,9
R_9U2QvPyqNW2XDvb,4,1,2,0,7
R_2Xb5qsmCzVLPb4f,0,4,4,0,8
R_3rP82wMDWlh5Iap,5,4,1,0,10
R_9zauPJG120fci6B,2,2,0,0,4
R_0xNhyEtR8hGG2jv,3,6,0,0,9
R_3L6AiUKQ7RuIB2f,0,2,4,0,6
R_1Ne2clZQQnxZxIO,6,2,1,0,9
R_tYuqJJXvPUlT6qR,6,4,0,0,10
R_10Z97vxox9RBNzo,5,4,0,0,9
R_cN3ZxAZ8uYA1pZf,3,5,0,0,8
R_CfDIhrUl22LSRUd,7,0,0,0,7
R_9AZ5cYUsqFPQmBP,5,1,1,0,7
R_BLHTHNydSd6dpQt,4,5,0,0,9
R_9N1iaLYJ1du9rhL,6,3,0,0,9
R_SBrlKgwr6vm3UBP,2,4,2,0,8
R_3Pt0068YyTXPRqh,2,4,1,0,7
R_1ovTnLfILbcpPLF,7,2,0,0,9
R_2q7PsKpear0aF5S,2,3,3,0,8
R_2floLXHXzVyy20s,2,3,1,0,6
R_3JrV5HYap6r3vSn,4,3,1,0,8
R_1NlhtW9plS1o5AU,4,3,0,1,8
R_29uDYTxHKV0aJET,6,4,0,0,10
R_1oiEGbBAT4fWCKM,5,2,1,0,8
R_rfqZlnXd1SeYid3,8,2,0,0,10
R_2EoyoUooKUhvRvZ,5,4,0,0,9
R_1DoM1CfbS7kXvHE,3,2,1,0,6
R_2qF31xxSNErWiUP,2,7,1,0,10
R_TaUWgFK44ukf79v,5,2,1,0,8
R_0c7hqMZ3Q2RMnkJ,8,1,0,0,9
R_2WD7vvLdoHJ2Kz8,5,2,2,0,9
R_1LCE1m8P5f5ozX6,5,2,2,0,9
R_2zToipwqo65R7Ak,2,3,4,0,9
R_vNBfabkfzuDj2gN,5,4,0,0,9
R_2TAdSzGGr9uZ2st,7,3,0,0,10
R_2PiiGtNog1zBw4B,8,2,0,0,10
R_29btfKgRQefKyum,3,5,1,0,9
R_pA773MovhLIdrbz,5,4,0,0,9
R_2sYWbuZ13nHGBZ8,2,5,1,0,8
R_3j6EU453PF1MI9W,6,2,0,0,8
R_3mfB3Oc9WrEHuIG,3,5,0,0,8
R_2rpTxM1jJr7PPsR,5,4,0,0,9
R_1pXOwnUDG2PpL38,8,3,0,0,11
R_3erwEjq5FbkV350,6,4,0,0,10
R_1g1kjM36fOovko3,3,2,0,0,5
R_2ypFb2V5bbSUmIT,5,4,0,0,9
R_3qpTpxVbKLX0lS3,3,5,1,0,9
R_C9zJkSbraI9plfP,8,1,0,0,9
R_51IksYNPyVGHGHT,0,8,2,0,10
R_PvMyEs6mhounhYZ,3,6,2,0,11
R_2cqJH4qqGS4H5cj,6,6,0,0,12
R_2QnAuIDUcQdTCOF,1,4,4,0,9
R_2vdId891EhCl39i,7,3,0,0,10
R_1rpQbZ98iyG9ovb,4,5,1,0,10
R_4PogvdfiCauSgUN,5,3,0,0,8
R_1gOXajqjKquVRh6,7,4,0,0,11
R_3nJAUrwe43vZyiz,6,4,0,0,10
R_3kCaY5oMtfFhECo,3,6,2,0,11
R_1OAHhNWOUPg9qcn,5,3,2,0,10
R_2YyKuXIjOf0KBvi,4,4,0,0,8
R_UGANVpc1memq969,1,5,2,0,8
R_2WuUkhlj3ePdDJe,4,3,2,0,9
R_2WTQiXUBXog3vcz,1,10,0,0,11
R_3QKmL19ev50O1tl,8,2,0,0,10
R_3P5q3EeUQlm6maN,1,1,3,0,5
R_3iCilgyEFo2LCjF,6,1,1,0,8
R_2BhwSBKoC2r5yd7,1,7,1,0,9
R_1GJrieNyBPj0mGi,3,2,4,0,9
R_bHFajxYlDHcPMf7,3,0,0,0,3
R_2qCU05eX1Wh5T0F,3,9,0,0,12
R_3p69XxqHN18agNZ,3,6,0,0,9
R_O9BgrunCH7YM9ln,3,6,0,0,9
R_yD3LdJUaQc2mQE1,7,2,1,0,10
R_3qstiA5GbkCDKyh,8,2,0,0,10
R_1P5dJTUnXb4bhuJ,7,2,0,0,9
R_1GEsWCh26PVxoDZ,2,3,1,0,6
R_3Jf2CCr3gvI7I7k,3,5,0,0,8
R_1DAOKlELNjENtmb,7,1,0,0,8
R_UDvHkgfLsG6arMl,4,4,3,0,11
R_qXvUNhCmt0LDfhv,1,6,1,0,8
R_cLR4DvFaUZfeiKB,4,5,1,0,10
R_3J3IRg5DU2r09Ec,9,2,0,0,11
R_1DwkCY4IKv32aiN,1,4,1,0,6
R_3MMg9MYyGxWrXdq,7,0,1,0,8
R_3PTBYtc3pZvh6VM,4,5,1,0,10
R_8oTIkrc0VrMUJYl,4,6,0,0,10
R_2XhNSIxHHY7Zr9v,6,3,1,0,10
R_25FUFU43JWOe6yH,5,5,2,0,12
R_2uZL8YZMNqZD6Xo,5,3,0,0,8
R_2OGPE6DPqswLE4v,3,5,1,0,9
R_1n8f6WV4lRdPfM3,4,4,0,0,8
R_25uRnTC3hHMeBf5,6,3,0,0,9
R_xfR56a1ciqI0t8d,4,1,0,0,5
R_2bHHJRLaFShANSs,5,5,0,0,10
R_3I6QjYa91EfSIPg,6,2,0,0,8
R_2rCJ8nA0iuxclej,5,2,0,0,7
R_1FaBJ1SGXwq2gcK,4,4,1,0,9
R_3ni2zO9nkcErA0I,0,2,6,0,8
R_1Qbiao2pzowkFJh,2,3,2,0,7
R_2WxaDZ9fCJQ02em,6,3,0,0,9
R_2AQOHSwlc81qhpx,2,6,1,0,9
R_2BhZ5E6Twq3kl2n,6,2,0,0,8
R_2uBrYZdlaWVIXCr,5,0,0,0,5
R_1GH6f3yKHnHvHri,5,5,0,0,10
R_1E4zWCXd1TpuSF6,0,1,7,0,8
R_2rSLyifAolGFpo5,7,0,1,0,8
R_1oCjBM1gtta6goI,5,6,0,0,11
R_10T6XRxegBS7bK8,4,5,1,0,10
R_1jTXiWEdYF48wBQ,0,5,1,0,6
R_2f88aJmywspQOUo,4,2,0,0,6
R_OycxSWxyMYllqEN,5,2,0,0,7
R_1Ok2iIt8s7ObAaK,2,5,2,0,9
R_2QriEDkdGIYD04a,7,6,0,0,13
R_3QLvjcoVDlODRR1,5,4,0,0,9
R_1mWAt93bplOdGZe,4,4,0,0,8
R_2PnC6s5uOR1JtwJ,3,6,1,0,10
R_2tJXNPrrpelaqND,8,1,0,0,9
R_2dfGbdN599JYLKK,0,0,4,0,4
R_bQQEpCm6vvuBGtH,6,2,0,0,8
R_3qkVQ0cbL38AAYJ,8,1,0,0,9
R_1jNTX1VBfb1pG9R,7,2,0,0,9
R_56Xbwk1ROwm9dFT,6,4,1,0,11
R_1GP5iRgvFSQmEXk,8,0,0,0,8
R_a9HeRSLTrz8fZU5,1,8,0,0,9
R_2OW0Pdw7EMuY42L,0,8,0,0,8
R_3Pl0QtAykn3FCjT,3,5,0,0,8
R_1jxfbxWGmo2Ssoj,1,5,3,0,9
R_1Kx6c8ntKLbBKvn,7,1,0,1,9
R_1IbmKNoWLu9Lpw7,9,1,0,0,10
R_3pc15JWKx8dCUMl,9,0,0,0,9
R_3HpP38n3k9haFBL,5,6,0,0,11
R_7PyDCGGyBKEOh7b,1,4,3,0,8
R_2tzZikSIO0lyNPY,3,5,0,0,8
R_3nl5EK6vXNiddgC,7,2,0,0,9
R_1It5JLOcSHy65Xf,8,1,0,0,9
R_3GqPTPnGooUbQOe,2,6,1,0,9
R_1d50uCbtc26rfkl,10,0,0,0,10
R_2tJTITY4v6xjUsI,5,5,0,0,10
R_2zq2sFgyZLud5Ga,5,1,4,0,10
R_2789B4WCycjydZp,5,4,3,0,12
R_yyBUfbsjXrZ9tYd,6,6,0,0,12
R_25SMrfuhoIw4FE7,5,3,2,0,10
R_10HQSx9H54Ua1rJ,4,5,0,0,9
R_b14q3kmFmdBTA3L,3,4,1,0,8
R_1KqZhWVHME54Uyk,0,5,4,0,9
R_2ZDMOPfqBNCoswX,6,4,1,0,11
R_3foTrpRuP7HMT5x,2,7,1,0,10
R_2sYExytrDlnV3RO,5,5,1,0,11
R_2qwxPBUggDVTXIY,8,1,0,0,9
R_2ePw1zPoDdbL43h,2,5,2,0,9
R_2R7YGY4G0gYvkFR,4,3,0,0,7
R_2Qh1ExD8cXWcnZw,4,4,1,0,9
R_OD6QkdIWhLJzRHr,0,5,5,0,10
R_1gINiFfugTPwbKf,7,2,0,0,9
R_2pXlF3myD8Xkojm,0,3,4,0,7
R_XtCwCFQ0BxXB2UN,4,2,0,0,6
R_t0sjlGOA9HEbipj,0,6,2,0,8
R_2c5jFIuWXhNQBHt,1,7,1,0,9
R_2zcC1Dn4zkOCZ7z,1,2,1,0,4
R_1GZcbqcUL9j9SzU,3,4,1,0,8
R_2ZQDwZoOVP60hYe,4,3,1,0,8
R_3ktYRTP9Cg4t40K,5,4,0,0,9
R_1r7ZryRSgCdC3tE,7,1,1,0,9
R_1IGXgXilOgaO3YA,5,1,2,0,8
R_2E007cgq0WpqhSx,0,5,1,0,6
R_7WAD2D35fCoxst3,5,2,3,0,10
R_2EcPmXpFMykAgee,6,2,1,0,9
R_33d4oE1g4NyEm1D,3,4,0,0,7
R_BPqFP6iJArRy4sV,3,3,2,0,8
R_etVpUJboP9vRLbz,5,4,0,0,9
R_D8AZEVgpOsW75a9,9,1,0,0,10
R_3ly3jJAo4pQVlDK,4,4,0,0,8
R_1H2KNPDQEl8SJVT,7,2,0,0,9
R_3GeTwYLXsv6UTwd,2,5,3,0,10
R_qJcKLOY9tCDHfcR,6,2,0,0,8
R_2vZUNAmcgjdu7U7,4,5,0,0,9
R_cMgssREdwaFQfND,6,5,0,0,11
R_10oM6iDTeYWAesX,8,2,0,0,10
R_3g4OhlWJGXjBZ3e,5,2,0,0,7
R_1cSWhgwAWp5bs5A,4,4,0,0,8
R_5biBlqof99NQ1qh,5,5,0,0,10
R_3stcdCBbz2vhsCD,0,6,1,0,7
R_3PdGv3mlwSj2A3O,4,6,0,0,10
R_3qakTfAASparyxy,3,5,2,0,10
R_895jk66nUyqGtXz,4,2,2,0,8
R_1rd1AhSeXEyhced,4,6,0,0,10
R_cCQ6D8AtA9Wpqs9,4,3,3,0,10
R_41U2bL3eoMNnorL,6,4,1,0,11
R_3POjKDmRTdICdDY,1,4,2,1,8
R_3FKfSu7iUQH2woS,7,2,2,0,11
R_1gHZl4T1TuJFPQh,6,2,0,0,8
R_3kjGGpNOkkEMeN8,3,5,0,0,8
R_2VqlCeHfpCpVBow,3,5,1,0,9
R_10NvLpA4EB7WxhK,0,5,3,0,8
R_1qUnffmqjciaQWl,5,4,0,0,9
R_DpMRqeZ2TrXPorf,2,2,3,0,7
R_3dL2itlsz24rOY3,5,2,0,0,7
R_2sSgdTDp9GUvOl3,3,0,2,0,5
R_3DpGcH8iJXKmoG2,6,4,0,0,10
R_30kl4qW22GjDIsV,4,4,2,0,10
R_1FfRSbSPsySWJWD,5,3,1,0,9
R_DHOXiupoB2D15VD,5,2,0,0,7
R_2VCsvRFamo5Dp8C,3,5,0,0,8
R_3CUcD9OhEAcfc25,5,4,1,0,10
R_27xGNf9rhqUjtub,2,5,5,0,12
R_2AHwMCSVFeSoPiN,6,3,0,0,9
R_ctZeaSSxX6sGnBL,4,5,0,0,9
R_3EN1Ca3Gb5fIcbJ,5,1,1,0,7
R_2EoSXG7xkRTIYDY,3,3,1,0,7
R_3NPAUjz6eUXqQQx,4,7,1,0,12
R_1ptFWmtNjHzgGZZ,8,1,0,0,9
R_12DR59qyqbmNw1G,6,4,0,0,10
R_3kdE9S43kGFZPT4,1,6,1,0,8
R_pmdfInSl7DKmpXP,6,4,0,0,10
R_2E6LoKtz6lqA4M6,7,1,1,0,9
R_Xh8oMAvGwiJEhwt,8,3,0,0,11
R_1gco4VzXvzHlcXQ,2,5,1,0,8
R_2wa8FoEHDWk0AGL,2,1,2,0,5
R_6o0UGpTbdr2jk0V,2,5,2,0,9
R_wSRyVvNjVEHgRMd,5,3,1,0,9
R_33eDsDu1w6zaAlu,3,4,1,0,8
R_T7cYiyQ1U4NUxaN,4,4,1,0,9
R_2zvjvXDseFJkEOV,7,2,0,0,9
R_237FaK6rQ25obhp,6,4,0,0,10
R_2af6r8cMf3uApeO,1,7,2,0,10
R_tGa2LWNmFol9Wy5,1,3,0,0,4
R_T6jOIUPrQo3dsnD,5,1,0,0,6
R_3G7awh21Da1spaa,1,6,4,0,11
R_31yiJ0DBaF0ny6M,1,5,4,0,10
R_3R4ldsnz9TN7wNS,4,6,0,0,10
R_qKj8PVk6ZDMj1Qd,0,5,4,0,9
R_2qdyhuV0sIjpYkM,5,5,0,0,10
R_1gu84prVg4hf0pp,3,4,1,0,8
R_3E9zaEiib7kehat,3,1,4,0,8
R_BLNwsA4de2aUSoF,7,1,1,0,9
R_2ysDGEyhdC6NDWL,6,3,0,0,9
R_3plsKVs7CVpv9iq,2,1,2,0,5
R_10O7QM1LoyUMScX,0,9,1,0,10
R_3dL0nQDllyKqGYo,7,1,1,0,9
R_2OZK4NMeE9m97jy,2,5,1,0,8
R_2DU2qW0rzupnoZE,5,3,1,0,9
R_1Edn4BiNSnLmfCW,4,10,0,0,14
R_2ONqcFj7IDR4cNY,1,8,1,0,10
R_R2i6zqztZSGbTX3,5,5,0,0,10
R_31WyvMAkt27bKwm,5,5,0,0,10
R_2UYsX9ZMIGleqL3,5,4,0,0,9
R_2xSrZu1gN6CG8DG,2,3,4,1,10
R_27d3eFmvqns3qBK,6,4,0,0,10
R_0ofZ9iK10veUYYV,8,1,0,0,9
R_31QqXlvMmdzO2sR,5,4,1,0,10
R_RxGipY6atYix2HD,4,5,0,0,9
R_2CKigVMCZnI0Tad,4,3,3,0,10
R_3KI7LmDDHiHXtQK,4,5,0,0,9
R_3HADhrImLLnIHyx,7,0,2,0,9
R_2wRWxqTtMdgtRXc,5,2,0,0,7
R_22DmibVGDikw5VS,8,2,0,0,10
R_27IEeFdg5BGBZFV,2,4,2,0,8
R_1pAm8rcLAje40Ee,5,3,0,0,8
R_2aesocaLTeX9GNM,5,4,0,0,9
R_1punOtB8BL9neTT,5,2,0,0,7
R_27JWbbGGNfy3a85,2,3,3,0,8
R_1NfVvztyPbqImVa,4,3,1,0,8
R_2zi6y9sCHzSWQL9,7,5,0,0,12
R_3JF9xnxg65tqoVt,4,3,2,0,9
R_1qhes50rSBWQURl,1,5,2,0,8
R_yKmMWtSWfMjCU3n,7,4,0,0,11
R_RWbRvs4ZIGOt8wp,6,3,1,0,10
R_3h0chj4tlZ8lJ1U,6,4,0,0,10
R_vuZURHw0AilEwJX,1,5,3,0,9
R_1CIMrlg33yKA95x,7,0,0,0,7
R_2YfjEEej8Om51mW,5,5,1,0,11
R_3KrKeZi7KBBf6Qy,9,1,0,0,10
R_W6eHt4mZURP2Ag1,3,6,1,0,10
R_3ghvk5sGjv5fv0Z,9,0,0,0,9
R_RrWwLTSNcyjZQJP,1,6,0,0,7
R_1lo5tNc2MHkhhTQ,1,3,4,0,8
R_10IWcFrsIKd4JJR,4,6,2,0,12
R_6xJCOuCKKHFxRcd,5,2,2,0,9
R_23f3MfE2vUyuI1j,5,3,0,0,8
R_3O6aZbvlD4iv9t8,0,4,3,0,7
R_31BrVkMuvk5W2aE,8,0,0,1,9
R_rl76kmXAPkKSonf,6,3,0,0,9
R_3RpDIgdGAH1kymK,3,5,1,0,9
R_1CCLgPj4be5uQpC,7,3,0,0,10
R_27dilwPrSOWe3II,4,4,1,0,9
R_30eFvu0xfVcuPPJ,1,6,2,0,9
R_1OZw3qcDvTyYij3,6,2,0,0,8
R_3kHrb1XtAs6WCju,3,5,0,0,8
R_oZTF100Jg3ICRgd,3,7,1,0,11
R_1dh4g0I66jKUOqx,6,4,0,0,10
R_AghCjlfysO196bD,6,4,0,0,10
R_3PvPm6OFgd2AtQd,7,2,0,0,9
R_3UIzfkTxMlalHgd,7,3,0,0,10
R_3Gm3iInctD1jQce,6,2,0,0,8
R_3M9aXho7XixHFwD,2,7,0,0,9
R_1IHqUiBfa4kUxIw,3,4,1,0,8
R_DDnXPfGfG1g3QIN,2,5,0,0,7
R_1gRRf2MwemzBcAw,3,5,2,0,10
R_3sb6vladqLKAuuj,4,3,3,0,10
R_3j82Uj0ZFB9hes3,5,2,0,0,7
R_2D2FQZtGERlVuub,7,0,0,0,7
R_1H04oJb22cjKljX,3,5,0,0,8
R_yyGnNf2CqDmyzF7,9,0,0,0,9
R_2RUF8ZZd4RJPcQO,3,6,0,0,9
R_2UfI6GbBev8sWBx,1,4,3,0,8
R_1kIDsMd6ECduwim,9,0,0,0,9
R_2XhRBuwDyWZEBRL,4,5,1,0,10
R_1OEaUaJw8QW3H3M,1,4,2,0,7
R_1l6r0WyHm9ytHve,7,3,0,0,10
R_eaCF2dR5LeT2yVX,6,2,0,0,8
R_3MmuuaEPjIGwenh,7,3,0,0,10
R_10ZylQYOMF4OtgK,0,7,0,0,7
R_3shwscg0rATz8gn,6,4,0,0,10
R_21EORahVRQ76D9z,4,4,1,0,9
R_VPGcfS9SH4XDqGB,2,5,1,0,8
R_2fpx07i1WY2sPnd,9,1,0,0,10
R_T6mZbnU7lP40OgF,6,1,1,0,8
R_w4Zzi7XtaRGR889,6,2,0,0,8
R_3nvpH19hkA5nuSU,4,5,1,0,10
R_2D6aowz8AoAZWdM,4,4,1,0,9
R_2QVx8zvQIL4NALD,2,5,3,0,10
R_2V2Yyfk2rTvO8Rd,7,3,0,0,10
R_3NUqexY7O9nszPL,7,2,0,0,9
R_1CwFySxhxzp3f3r,7,3,1,0,11
R_7QYo4gSCcSG90fT,8,2,0,0,10
R_30vF2pOC3wlt1El,4,6,0,0,10
R_32LqjLjZf0pAawe,4,3,1,0,8
R_uxqQQlytsLh0NB7,5,3,0,0,8
R_2QA1zkVwu8boYcR,5,1,1,0,7
R_2qyMLFR12oC7dSd,4,5,1,0,10
R_3koX5AXfwtPPYdF,2,5,1,0,8
R_sb98KVRPy0EOSQh,3,3,0,0,6
R_3gTW1CvBgNwGrJI,8,2,0,0,10
R_3EfBA58YNXHWHPH,9,1,0,0,10
R_2f8KXE98wmHipzm,1,5,0,0,6
R_21Brl2GzxlOe54t,10,1,0,0,11
R_2736c251VBdTiF7,4,3,0,0,7
R_8wb1IQucaC2jg7T,4,5,0,0,9
R_TgOHaFL3wbyUrPH,6,4,0,0,10
R_1hYeEihynzAXD2G,2,4,1,0,7
R_5orpStcfJOfHMvn,2,4,1,0,7
R_1DGBDsTW4ZcHcRY,4,2,4,0,10
R_3FIIsL46y99QKP2,3,8,0,0,11
R_23ZW9Q7ipzH5QPB,2,4,0,0,6
R_3kp8JYPqPunJJUN,7,2,0,0,9
R_2V4L4hFUvupQWBH,0,7,0,0,7
R_3MAPeiuQdxcu4dt,6,2,0,0,8
R_2rw2TzCVmyjS7tj,3,6,0,0,9
R_3Odh3nFeXNJrzbi,5,2,1,0,8
R_2Eo5LzOtA7naLgp,4,3,1,0,8
R_27yecT1vuC1YHqt,3,5,0,0,8
R_9Ad2o7qKGhW3yNz,4,4,0,0,8
R_1Qrx3scnup7sH6e,6,1,1,0,8
R_2rYDJUyEKaMQDsL,6,3,1,0,10
R_1jIoc3NwikeQG1S,8,1,0,0,9
R_2zU5H5qaLaAfV8n,0,4,4,0,8
R_1GZbYwHAf3FR01w,2,5,2,0,9
R_2zbCEcOMkMppuej,2,7,1,0,10
R_3MF3HmqzBxFOrYQ,2,3,2,0,7
R_22raDQTYe9u1DW0,4,5,0,0,9
R_2OUfCsL3pRtuX6t,4,3,2,0,9
R_vjbTjjJnAkhgxGN,4,5,2,0,11
R_85GIrD3hpQfIztf,6,4,1,0,11
R_25Fq4lh1gnefg5V,0,0,6,0,6
R_2zhxzzeIaX2f0jQ,7,3,0,0,10
R_2CUq6ZlmOc60tN5,2,4,3,0,9
R_2rjcFxIIZAkO6Ho,3,6,0,0,9
R_RVQfenZoqviZSnL,2,5,1,0,8
R_24vKm00gIEm6H7o,7,4,1,0,12
R_2AWFfKoOZIwReSW,5,4,0,0,9
R_1erVGjESeujWKN1,2,4,2,0,8
R_pbnmUm0zB8geSyd,6,3,0,0,9
R_12u64w2WQ603P51,2,7,0,0,9
R_1OxEhjNUHgrIeuz,0,6,3,0,9
R_1jZAYW0Q93em4xS,5,5,0,0,10
R_1gqLcvRHenF8kaM,4,6,0,0,10
R_23WWVUvltbtsCFH,5,3,0,0,8
R_2qaR0HbHQYrWCEQ,6,1,0,0,7
R_2RazB8srdIhxfqF,2,6,0,0,8
R_24JmFGfpdAgJpV0,0,2,6,0,8
R_UyfifmPpSsPq12h,4,3,0,0,7
R_2qgeB7kuE5rGBTW,2,5,1,0,8
R_3Oe0Q235micTvDy,5,4,0,0,9
R_2QWnUWsWenJuX29,7,2,0,0,9
R_WfFZPwBIcYJfkpX,6,3,0,0,9
R_1Kwhn1kbprGGGIy,6,3,0,0,9
R_1oiG9oL5hUd8DGr,0,8,1,0,9
R_2V2svo7fZC08oxS,3,2,0,0,5
R_290u0fSOODFWO0Y,4,1,3,0,8
R_3R1M5eB5JUyVBbe,4,4,1,0,9
R_s5ronWpQP5dFePT,4,6,0,0,10
R_3MlfrryQOoyeW2z,7,1,1,0,9
R_33fOiCJx1FSbqjK,1,7,1,0,9
R_6Q2r2VK4r91tdeh,5,5,0,0,10
R_W1g1OQ5a3B3AsAp,0,3,0,0,3
R_1LGOWbEg1OKZqUO,8,1,1,0,10
R_1C6XgjqaCTDgceU,4,5,0,0,9
R_3isZNZMbz1nM2Ex,6,2,0,0,8
R_1jy4gDIrLm7G6vG,1,5,1,0,7
R_2QzgIUm01pB9Nfg,3,5,1,0,9
R_10UYjUJuYIsQ6qu,7,0,1,0,8
R_3NQTerfU7aVckuJ,3,7,0,0,10
R_6RPNcjnNBF2m7lL,4,6,0,0,10
R_3iEGofUY6gxDxPm,3,3,0,0,6
R_2whRhVxDhFOXMMB,5,3,0,0,8
R_2b11uD9B4x6nPob,2,3,0,0,5
R_3kpQVbIQTVqg8rb,0,0,10,0,10
R_Zfydy424yGPI3GF,2,4,2,0,8
R_3PiRMgnpDwjg4Ao,6,1,0,0,7
R_3O66dT1qkbDP8D0,3,2,0,0,5
R_qLbLF6wrH2tuKVb,4,3,0,0,7
R_21d3jqcfoqdpDJe,4,3,2,0,9
R_1QlTo0n5anYkkFg,8,6,0,0,14
R_1d1fFMKyeBo6Q29,0,0,7,0,7
R_2aaZTVGBuwkOSEA,4,5,1,0,10
R_2SrEbTuqK3jLvjZ,5,2,0,0,7
R_1NmELz6bPQmG8mw,6,2,1,0,9
R_3hiRU2uTa4RsTgs,6,1,0,0,7
R_1QzLqcSnwO84zF8,7,1,0,0,8
R_3gY5OYqRr3vyuHK,5,4,0,0,9
R_2VjSygywH1KSowh,6,3,1,0,10
R_DV5Eq0C7GfqQGrv,7,0,2,0,9
R_20OpYWkJryP7whg,5,1,2,0,8
R_3IexnjlN1BbsCwF,7,3,0,0,10
R_aeLb68pxZWlQXq9,6,3,0,0,9
R_3h2b6xisudKXgGt,3,4,2,0,9
R_2v0blgXfPUHHoGf,2,5,0,0,7
R_294ZBuPjsFvCSOn,8,2,0,0,10
R_2CWAHu9CP1TPFAt,9,1,0,0,10
R_3J28GVab3lySas1,9,1,0,0,10
R_3I3sLsbAT17gH9I,5,3,0,0,8
R_9Swo0e7OFRQjXSF,4,5,0,0,9
R_29m1JRlz2K0jiHj,2,3,5,0,10
R_1hF1o9eFjRg8e8e,4,4,0,1,9
R_29hKaycyTx87saB,2,4,0,0,6
R_WpzkWiC9RY9Cv9D,3,4,1,0,8
R_231zSFliZMvSMZ4,9,1,0,0,10
R_3me46ZKNnTiDhYn,2,10,0,0,12
R_3imXuTtGLKn8Ep2,1,2,4,0,7
R_O9y4qX6w3j7Rmox,1,2,2,0,5
R_2dnWDRBbg5pIFzu,5,4,0,0,9
R_1Qb8Rf6E87K4Ixo,5,3,0,0,8
R_3s552nZo2Ckze6H,0,3,5,0,8
R_29vxCGFzwopy5Nw,5,2,0,0,7
R_3K1x56IXJ4iUOBj,4,5,0,0,9
R_sYyDsXXwHZYwN7r,7,2,0,0,9
R_pgfU88TwCq2QupH,6,3,0,0,9
R_3KoQFnA25iP95AZ,4,2,0,0,6
R_22na0eEWNuCaTIL,6,1,0,0,7
R_2Pp9pihlgE22XVi,6,1,1,0,8
R_xap9HSXpITKNFo5,2,7,0,0,9
R_U9mroHMjGQORVeN,3,6,2,0,11
R_3pnV8ZN1aADTrKN,0,1,0,0,1
R_1gtmgLJZtkiGDgq,3,3,0,0,6
R_3FWDYQshpaZQNmV,0,1,4,0,5
R_2tsWDMa3S4Yhsca,6,3,1,0,10
R_2rGhfuFh5tei6am,5,4,1,0,10
R_3QGJoNoYw3DyaYM,1,6,2,0,9
R_1ri7rWRBzJh0evr,8,3,0,0,11
R_XHO4pdi94xdi2fD,3,2,1,0,6
R_roL9dFrCUTJW69b,1,5,4,0,10
R_12M8ObQRU6Z3ouM,10,0,0,0,10
R_1IRdJjFZgZM4iyg,7,1,0,0,8
R_3QWPvwjpSFVhE06,9,0,0,0,9
R_CZDtvEjKAfs5git,4,4,0,0,8
R_3GB7lu0fPVqYL16,5,4,1,0,10
R_2BbRzEmbVpN3G3w,0,7,0,0,7
R_2UVJ9n2JxWUhOTS,3,6,0,0,9
R_2R9cZimxbTmT7SI,4,3,1,0,8
R_XNb9NwHTs6BI2fn,1,3,3,0,7
R_a2yNxkbnHQMZupj,4,5,0,0,9
R_UFkaeXZGnZ6Us5b,5,4,0,0,9
R_110AGSV30QrCwG7,0,4,5,0,9
R_2c1lQkTE7jKmcyu,2,7,0,0,9
R_2WuLn4E4OPKDiQE,4,4,1,0,9
R_3Ez1xFb4zgxQFZK,7,3,0,0,10
R_ZsLrSRcQF2tzdDj,1,3,0,0,4
R_1j6YbL2zzeOn8KU,6,4,0,0,10
R_aaxgRQMmFNMfSkp,5,2,1,0,8
R_3iwij9UHLO9hwdX,5,4,0,0,9
R_1kMQysXdXC7Afn8,1,5,2,0,8
R_3mlujiKGbZF2NDr,3,7,0,0,10
R_AgL6VauwJgdQCe5,6,3,0,0,9
R_1NeovebC2g1BCDQ,4,3,1,0,8
R_26kwy7PS1ygwhrP,5,2,0,0,7
R_2uJ1LgCN9BEMFHC,2,6,2,0,10
R_3m2mI689zCfrqi0,6,3,0,0,9
R_1OHagZ9GwmoJuFX,3,4,0,0,7
R_eWkcSOwDlwrn5Ul,5,3,0,0,8
R_2S8m8VULa2Hmg5u,6,1,1,0,8
R_1eDL1A92UvlFJGP,6,5,0,0,11
R_0wF40p4aKYhYm7T,6,2,0,0,8
R_31zIKi21UndNl8n,5,3,0,0,8
R_3NZXz3JptqOee8B,2,6,0,0,8
R_2U5ED577FWwBvUW,5,3,0,0,8
R_2tJvmIxtLfSFu9l,7,2,0,0,9
R_1JWnhFEdVg5tR0T,3,1,5,0,9
R_3kIgleumg6EPCom,2,4,1,0,7
R_1riDKwTzlgZTubg,2,4,1,0,7
R_OlPdd8dbC54kMMh,5,0,0,0,5
R_1I4xNm94XRyED56,0,2,6,0,8
R_2UXeMygyydFlndP,3,4,1,0,8
R_28HZadgDqIMx2FU,6,2,0,0,8
R_2YxhlUr9RRvhyFR,6,2,2,0,10
R_9oadZUFAwk943XH,5,5,0,0,10
R_3315zBZx7Iu99oV,9,0,0,0,9
R_2amo59ZvL51Zi81,2,5,0,0,7
R_yQEe3pqkI88ZWwN,1,5,0,0,6
R_2SI8MkOd3z5deL2,5,3,0,0,8
R_2sbWd7brV4l5STt,2,4,1,0,7
R_2gdUrSJHI5nEhcR,6,3,0,0,9
R_1rcZDLgIi7pne1Q,3,8,1,0,12
R_YXD3t8tvaswTQVb,4,2,0,0,6
R_3oYICrbBjs4sNfN,2,4,1,0,7
R_1NrIfUj7cetOlYK,1,5,2,0,8
R_siDD6IyHVXwpgiZ,0,4,4,0,8
R_21AMyNW3TejZS1z,6,3,0,0,9
R_2TtrNAvRKGM3Aab,2,3,3,0,8
R_yrRB4X47hu4WKWZ,1,2,6,0,9
R_3OfeCbHi2My1ioM,8,0,0,0,8
R_27NEyyl71YlyKIh,2,5,1,0,8
R_0V9My84OXYyBhZL,5,5,0,0,10
R_2tsR61NPHox0UgP,0,7,2,0,9
R_1F4hdPnYt3yVJLT,9,1,0,0,10
R_3Hn6xr8qt3wvDTj,1,6,2,0,9
R_2QXM0hKhKJvGu6S,4,1,5,0,10
R_31Wzw7Q2eHZ6ka1,7,1,2,0,10
R_3snn0Inmh7GCvxD,7,3,0,0,10
R_1H7rHYIDTlptV1j,5,2,1,0,8
